agyögwëh	agyö gwë h
waëögo’	wa ë ögo ’
o’gagweni’	o’ ga gweni ’
dogësgowah	dogës gowah
o’shagonöhgödë’	o’ shago nöhgödë ’
agyeisdöh	ag yeisdö h
högwëh	h ögwëh
wadiögo’	wa di ögo ’
ëöjënöni’	ëö jënöni ’
niyonö’net	ni yo nö’ne t
ëgwadwënögahdë’	ë gwa dwënögahdë ’
ageksa’dëögwëh	age ksa’dë ögwëh
eonöjoö’	eonö joö ’
shagodës	shago dë s
ësgwëdëhsek	ësgwëd ëhsek
waanyo’	waa nyo ’
da’adinyo’	da’ adi nyo ’
awëiyoh	aw ë iyo h
së’ëh	së’ëh
wa’odö’öje’	wa’ o dö’ öje’
waadö’	wa adö ’
ganökda’	ga nökd a’
ësa’nöhgödë’	ë sa ’nöhgöd ë’
dwahsa’	d w ahsa ’
dijahsawëh	di ja hsa wëh
ëgahsawë’	ë g ahsawë ’
heyohsa:’	he yo hsa :’
nö’gë’gwah	nö’gë’gwah
agawëh	ag awë h
ögwawëgëö’	ögw awë gëö’
o’tahsa’get	o’t ahsa’get
o’wayagës	o’ w ayagë s
hoyaköh	ho yak öh
sa’gwah	sa’gwah
ganö’gwes	ga nö’gwes
gashaisdowanëh	ga shaisdowanë h
deigowanëh	de i gowanëh
tgowanës	t go wanë s
degäwisdaöh	de gä wisdaö h
hësgaho’	hë s gaho ’
gais	ga is
dzësda’ë:’	dzësda’ë: ’
gohgwasöh	goh gwa söh
ojiwë’da’	o jiwë’d a’
yo’jiyös	y o’jiyö s
shödowähgowah	shödowäh gowah
onöhgwagai’ni’	o nöhgwagai’ni’
gaöyo’	ga öyo ’
yeya’dëöje’	ye ya’dë öje’
haya’da’geh	ha ya’d a’ geh
de’o’nëya’	de’ o ’nëya ’
dwatgeö’	d w atgeö ’
ëshadöhe’t	ë sh adöhe’ t
hanyasdagöh	ha nyasd agöh
ehda’geh	ehd a’ geh
dewagënönya’göh	de wag ënönya’g öh
yötöwisata’	y ötöwisat a’
yënëshahasta	y ënëshahast a’
oikdatgi’	o ikdatgi ’
o’tayanö’dahgwiya’k	o’t a yanö’dahgwi ya’k
o’töwöwasas	o’t ö wöwasas
odädzö’	o d ädzö ’
yenö’gwa’geh	ye nö’gwa’ geh
honösgoöh	honö sgo öh
hënödaja’teh	hënö daj a’t eh
o’dwagyë’hihdë’	o’d wag yë’hihdë ’
dewagaja’gih	de waga ja’gi h
osgawagöh	osga wa göh
da’deyoni’ö:’	da’ de yo ni’ ö:’
wahnöhsöni’	wah nöhs öni ’
gwanënoh	gwanënoh
onënoshä’	o nënosh ä’
o’gënis’ohtë’da:’	o’ g ënis’ohtë’da :’
agötwëh	ag ötwë h
o’dwadä’nega:’	o’d w adä’nega :’
o’gehsadö:’	o’ ge hsadö :’
osgawa’	o sgaw a’
odiwade’	o diwade ’
dayëhö:’	d a yë hö:’
dzonyo’gwes	dzo nyo’gw es
ëögöshe’daninö’	ëögö she’daninö ’
göwöninöh	göwö ninö h
ojisdanohgwëö’	o jisdanohgwëö ’
hadiyashö’	hadi yashö ’
de’göwöyas	de’ göwö ya s
šasöh	ša sö h
gayasönö’	ga yasö nö’
nö’göka’	nö’göka’
owänöe’shö’öh	o wänöe’shö’öh
hodiöwö’shö’öh	hodi öwö’ shö’öh
ho’sehdayë’	ho ’sehda yë’
ögweh	ö gweh
hëöshëö’	hëöshëö’
esniwayeis	e sn iwayei s
odiöniaje’	o diöni aje’
haawi’s	ha awi ’s
hegawi’s	heg awi ’s
o’gidzayenö:’	o’ g idza yenö :’
ösagahgëni’	ö sa gahgëni ’
tëhdähdane’	tëhdähdane ’
wanösgai’	wa nösgai ’
oiwa’geh	o iwa’ geh
gayogweonö’	ga yogwe onö’
ogaehda’	o gaehda ’
niyökiya’do’dësdöh	ni yöki ya’d o’dësdöh
nö’donënishägeh	nö’do nënishäge h
yöjëdahgwa’	yö jëdahgw a’
dzaenös	dzaenös
dzodö’öh	dzo dö’ öh
sadahgwadenih	s adahgwa deni h
o’tgadisja’kö:’	o’t g adisja’kö :’
hënödëshe’	hënö dëshe ’
sadowih	s adowi h
waoshe:’	waoshe:’
hadishe’s	hadishe’s
nëyagyadi’sdaë’	në yagy adi’sdaë ’
gadahosgwa’geh	g adahosgw a’ geh
osae’da’	osae’da’
hadihsënowanë’sgwa’	hadi hsënowanë ’sgwa’
goawak	go awak
yeksa’ah	ye ksa’ah
deniksa’ah	deni ksa’ah
swaksa’shö’öh	swa ksa’ shö’öh
degaksa’dageh	de ga ksa’dage h
ohgaa’	o hga a’
waöwöya’dägo’	wa öwö ya’d ägo ’
ganëita’	ga nëit a’
ga’säde’	ga ’säde’
ga’daa’	ga ’da a’
yöne’shäde’	y öne’shäde ’
dagaja’dën	da g aja’dë n
saja’dën	s aja’dë n
hä’tës	h ä’të s
deyögwada’swekö’	de yögw ada’swekö ’
ëshahodö:’	ës ha hodö :’
dosgëh	dosgëh
dwatgeö’	dw atgeö ’
hajanöt’ah	h ajanöt’ ah
onegajih	o negaji h
gotowinyö’seh	go towinyö’se h
ëganö’nostak	ë ga nö’nost ak
onyaa’	o nya a’
goögwëh	go ögwëh
o’daishä’	o ’daish ä’
ganöhda’	ga nöhd a’
sadotgah	s adotgah
ëtösënök	ët ösë nök
de’shakdös	de’ sh akdö s
wa’öhget	wa’ ö hget
ho’wahget	h o’ wahget
gökdöne’	gö kdön e’
itet	it et
tödayën	t öday ën
nödaëne:’	nöda ën e:’
ëyoäk	ë yo äk
waënödiwis’a:’	waënö diwis’ a:’
odöhedöh	o döhed öh
ëgadwiyäkdönö’	ë gadwiyäkdön ö’
o’wadä’nëdahsi’	o’ w adä’nëdahsi ’
dae’	d a e ’
tganödayë’	t ga nödayë’
ganödagwëhda:’	ga nödagwëhda :’
agiwihsa’öh	ag iwihsa’ öh
hasdeista’	h asdeist a’
ëhniwaniyät	ë hn iwaniyät
dëyago’nigöhgëni’	dë yago ’nigöh gëni’
eodigayëh	eodi gayë h
ëwödak	ë w ödak
asgënö’gëök	as g ënö’g ëök
ëhse’nisdo:’	ë hse ’nisdo :’
aknö’dzot	ak nö’dzot
ëgaih	ë ga i h
yödeyas	yö deya s
ojiä’	o ji ä’
onö’	o n ö’
ojigwës	o jigwë s
otgi’	o tgi ’
gëöshä’	g ëösh ä’
ogösgwi’ä’	o gösgwi’ ä’
ëgadöishëdahgwak	ë g adöishë dahgwak
agahsa’gëh	ag ahsa’ gëh
yöshedas	yö shed as
geih	geih
agadawe’sëöh	ag adawe’së öh
ëkwahsö:’	ë k wahsö :’
wa’e’howek	wa’ e ’howek
ganö’gwat	ga nö’gwat
yeöshë’	ye öshë ’
deyötšosgwine’s	de yö tšosgwine ’s
hayanö’dahgwa’	ha yanö’ dahgwa’
wadehšöni’	wa dehšöni ’
gëhowanëh	gë ho wanëh
hotgënih	ho tgëni h
dëöëjiya’ktak	dë öëjiya’kt ak
nö’desoshiya’göh	nö’des oshiya’g öh
o’tgyaya’k	o’t g yaya’k
dewata’se:’	de w ata’se:’
gëjohgwasdë:’	gë johgwasdë :’
shënösdëönyöh	s hënö sdëönyö h
gasdaha’	g asdah a’
gosda:’	go sd a:’
degawisdageh	de ga wisdage h
gayadöshä’	ga yadösh ä’
wa’agwayëja’k	wa’ agwa yëja’k
hodatenëh	ho datenë h
ëhšya’k	ë hš ya’k
hanö’gwatënyeta’	ha nö’gwatënyet a’
waënëni’dze:’	waën ëni’dze :’
dedwat	de dwa t
wajih	w aji h
ëyo’gäh	ë yo ’gä h
hagesa’	hage sa’
ohë’šönyöh	o hë’šönyö h
sayohë’t	sa yo hë’ t
ëwënishädek	ë w ënishäde k
niawënishägeh	ni a wënishäge h
de’ga’swegöh	de’ g a’sweg öh
wayadiwis’a:’	wa y adiwis’ a:’
honyögwaiyo’	ho nyögwaiyo’
waëni’dodë’	wa ëni’dod ë’
o’tgya’dowet	o’t g ya’dowet
waiya’daa’t	wa i ya’daa’ t
dewagya’dowehdöh	de wag ya’dowehd öh
ojihaya’	o jihay a’
ëgö’šodägo’	ë gö ’šodägo ’
agieyöh	ag iey öh
ganyo’agwah	ganyo’agwah
aknoö’	ak noö ’
dawaknoö’	da wak noö ’
ge’eohdogwas	ge ’eohdogwa s
ho’gwa’nigöëgahdë’	ho’ gwa ’nigöëgahdë ’
onöhsatgi’	o nöhs atgi ’
ho’wahdö’	ho’ w ahdö ’
deyodëhsëögwëh	de yo dëhsëög wëh
gaënö’	ga ën ö’
sadaweodëh	s adaweod ëh
toiwadiyödanih	t o iwadiyödani h
o’wënöda’säh	o’ wënö da’säh
wa’öhdoh	wa’ ö hdoh
doja’ja’göh	do j a’ja’g öh
o’gedzagö:’	o’ge dzagö :’
hegagön	he ga gö n
niyöjehak	ni yö je hak
niodiyeëh	ni odi yeëh
nayagoyeök	na yago yeök
hajanö’ta’	h ajanö’t a’
hodigöhsosga’ah	hodi göhsosga’ ah
gaya’da’	ga ya’d a’
hënöh	hënöh
degahoot	de ga hoot
hanesdi’se’s	ha nesdi’se ’s
wa’ögwa’se:’	wa’ ögwa’se:’
oisëhdase:’	o isëhdase :’
ohësdanö’	o hësdanö ’
honegeëh	ho nege ëh
ëswanegeäh	ë swa nege äh
snegeönyöh	s negeönyö h
ösawage’se:’	ö sa wage’se :’
wadowi’	wa dowi ’
wadashaenë’s	w adashaenë ’s
wënöhgwisas	wënö hgwis as
gaha’döh	ga ha’d öh
twaën	twaën
o’gë:’	o ’gë :’
ögwanögenyök	ögwa nögenyö k
o’gawë’daë’	o’ ga wë’da ë’
yöhdagöh	yö hdag öh
deyodöëdzo’kdahgöh	de yo döëdzo’kd ahgöh
yöëdza’	yö ëdz a’
dedwagatšo’dësdöh	de d wag atšo’dësd öh
hëyagoa’danöwë’	hë yago a’danöwë ’
dzögwagöh	dz ögwa g öh
ögwadekönih	ögw adeköni h
ëdwadeköni’	ëdw adeköni ’
gë’das	gë ’da s
dayohsa’öje’	da yo hsa’ öje’
dewahgëön	de w ahgëön
dega’höhsageh	de ga ’höhsage h
niwashëh	ni w ashë h
sgasgae’	sga sgae’
agadeë’öh	ag adeë ’öh
dëwënöëdzotga’wahsek	dë wënö ëdzotga’w ahsek
o’kedzaö’	o’ ke dzaö ’
dënë’nigöëwënya’tak	dën ë’nigöëwënya’t ak
onödö’se’öök	onö dö’se’ öök
hösayagoyönöje’	hösa yago yönö je’
oni’öhganya’göh	o ni’öhganya’g öh
ëgade’go’	ë g ade’go ’
onya’da’	o nya’d a’
o’gäs’anegwah	o’ g äs’ane gwah
otgö’	o tgö ’
hodikdö’	hodi kdö ’
hadikdö:’	hadi kdö :’
hëh	hëh
deyodä’negëöh	de yo dä’negë öh
yega’geh	ye ga’ geh
hagösgahat	ha gösgahat
hëyötgahdë’	hë yö tgahd ë’
odahsogwëh	o dahsog wëh
o’gya’jenë’t	o’ g ya’jenë’ t
ho’wa’së’t	ho’ w a’së’ t
hadiya’jenëta’	hadi ya’jenët a’
yewajiyä’	ye wajiyä’
wa’ödäwak	wa’ ö däwak
osnowe’	o snow e’
hohsëh	ho hsë h
shagwa’nigëö’	shagwa ’ni gëö’
joiwa’shö’	j o iwa’ shö’
ganönyowanëh	ga nönyowanë h
ëshekwanön	ë she kwanön
do’nigöhganyëh	d o ’nigö hganyëh
dzödögweta’	dzö dögwet a’
o’wadögwe:’	o’ w adögwe :’
yeöh	ye ö h
shagowenoa’	shago weno a’
onya’gä:’	o nya’g ä:’
nigahšö’shägeh	ni ga hšö’shäge h
niwashëh	ni w ashë h
waya’dasgeha’	wa ya’dasgeh a’
deyoöyogëhö’	de yo öyogëhö ’
ogawehšön	o gawehšön
ësgegë’s	ë sge gë’s
ge’nya’geh	ge ’nya’ geh
sanio’kdë’	sa nio’kd ë’
šënëda’t	š ënëda’ t
waënötëdihsa’hö:’	waënö tëdihsa’hö :’
tsa’wadahgwi’	tsa’ w adahgwi ’
ojisda’geh	o jisd a’ geh
yödega’dahgwa’	yö dega’ dahgwa’
ëgyëdagwa:’	ë g yëdagwa :’
dawajeën	da w aje ën
dajeëhdak	d aje ëhdak
gëdzanöge’	gë dzanöge’
gais	ga i s
yötwadaseta’	yö twadaset a’
ëwödo’gäk	ë wö do’gäk
ote’shä’geh	o te’shä’ geh
awëön	aw ë ön
haya’döje’	ha ya’döje ’
hadije’s	ha dije ’s
deyoshadohgwayë’	de yo shadohgwayë ’
o’dwaja’së’	o’d w aja’së ’
aöwöyanëö’	aöwö yanëö ’
waöwöshe:’	waöwö she :’
okwaih	o kwai h
dwatgeö’	dw atgeö ’
gajisgwa’eh	ga jisgwa’eh
gegë’dza’geh	ge gë’dz a’ geh
hëgadaje’	hë ga d aje’
gahsigweoa’	ga hsigweo a’
niwashëh	ni washëh
oëdöh	o ëd öh
geih	geih
onösdagehdet	o nösdagehdet
gayanöse:’	ga yanöse :’
oëhji’ä’	o ëhji’ ä’ 
gyadeoh	gy ade oh
ögahjön	ög ahj ön
osä’öh	o sä’ öh
wayatgësta’	w ayatgëst a’
ësdagi’da:’	ë s dagi’da :’
o’ganöhsih	o’ ga nöhsi h
ënödëdetgädö:’	ënö dëdetgädö :’
honöjanön	honö janön
nö’watganye’tšishe’	nö’ w atganye’tšish e’
gatganye’shä’	g atganye’ shä’
oëda’	o ëd a’
shögwaya’deegöh	shögwa ya’deeg öh
ëjisnoekö:’	ë jisn oekö:’
wa’ögwaya’dayeih	wa’ ögwa ya’dayeih
hodiya’dayei’öh	hodi ya’dayei’öh
goya’dayeista’	go ya’dayeist a’
o’tagahada’t	o’t a gahada’ t
ënöde’nöhdaah	ënö de’nöhdaah
dëhnyadi’he’t	dë hny adi’he’ t
satgëh	s atgëh
sade’sgogoh	s ade’sgogo h
wa’e’nigöëdogëh	wa’ e ’nigöëdogë h
jodeëhdanih	jo deëhdani h
ëwögegë’dë’	ë wöge gë’d ë’
dëyadä’negë:’	dë y adä’negë :’
hatgëös	h atgë ös
dö’ödagatgëh	dö’ öd ag atgë h
ga’gagowah	ga’gagowah
tidwagatiöh	ti d wag atiöh
wa’öde’dö:’	wa’ ö de’dö :’
daskwisdöh	da sk wisdö h
o’tagänöhdo:’	o’t ag änöhdo :’
o’tgyadahnönyö:’	o’t gy adahnönyö :’
da’age’nigo’kda’öh	da’ age ’nigo’kda’ öh
ëgöyö’	ë gö yö’
dasgöh	da sg öh
awisahdöh	a wisahdö h
sanya’dowis	sa nya’dowi s
o’jagwayaya’k	o’jagwa yaya’k
dayagoya’dawëhdake’	da yago ya’dawëhdake ’
wa’agwagwa:’	wa’ agwa gwa :’
gekdönöh	ge kdön öh
hënötganye’he’s	hënö tganye’h e’s
ëgënöeta’	ë gë nöet a’
ëtgöyö’sene’	ët gö yö’sen e’
sawahdëdi’	sa w ahdëdi ’
dödagahdëdi’	döda g ahdëdi ’
hëtsahget	hët s ahget
agasnowädöh	ag asnowädö h
heahwas	he ah was
wadowäta’	w adowäta ’
o’shagoya’dihsaka’	o’ shago ya’dihsak a’
dayagë’t	d a yagë’ t
heshonötgödahgöh	hes honö tgöda hgöh
dëjötgödak	dëjö tgöda k
hëëne:’	hë ën e:’
hëshëne:’	hësh ën e:’
nidisenöh	ni dis en öh
wa’awenöje’	wa’ aw en öje’
hëswet	hë swe t
dawadiyagëhdak	da wadi yagëhdak
goäho’	go äho ’
wa’agwahdahgwagwa:’	wa’ agw ahdahgwagwa :’
ëödeyës	ëö deyës
hi’eodane’s	hi’ eodan e’s
dagaën	dagaën
o’gadawën	o’ g adawën
ige’	i g e ’
dae’	d a e ’
ishe’	i s h e ’
waënöhdëdi’	waënö hdëdi ’
niënöhdëjösgwa’	ni ënö hdë jösgwa’
hawëniyo’	ha wën iyo’
ga’sehdiyoh	ga ’sehd iyoh
gëdiyoh	g ëd iyoh
honödä’swiyoh	honö dä’sw iyoh
ohiyoh	o h iyoh
honödënetgädö’	honö dënetgädö ’
sawiyo’he’t	sa w iyo ’he’ t
yöda’doäta’	yö da’doät a’
onyöhsa’	o nyöhs a’
waöwöyenö:’	waöwö yenö :’
wa’eyenö:’	wa’ e yenö :’
keyade’	ke y ade ’
ëkeyade’shö’gëö	ë ke y ade ’ shö’ gëök
aksotgëö’	ak sot gëö’
etihsot	eti hsot
ogwaa’	o gwa a’
hënö’etšiyoh	hën ö’etšiyo h
o’kdagö’	o ’kdagö’
shosheowa:’	s ho she owa:’
ogeo’dza’gea’	o geo’dz a’gea’
dëdzagodahnöönyö:’	dë dzago dahnöönyö :’
wagö’	w agö ’
yone’sä’geh	yo ne’s ä’ geh
nigëjohgwa’	ni gë johgwa’
wa’ödojak	wa’ ö dojak
odönih	o döni h
ot’eohdönih	o t’eohdöni h
hadënöh	h adënö h
deyöknyadödaikdöh	de yökny adödaikd öh
ësnyatganye’hah	ë sny atganye’ hah
agege’ä’	age ge’ ä’
ha’deswahsënöh	ha’ de s w ahsënö h
o’nya’	o ’ny a’
gënöh	gë nö h
ëhsniyödë’	ë hsni yöd ë’
nëtgaiwayä’dak	nët ga iwayä’d ak
de’sa’nigöëwë’öh	de’ sa ’nigö ëwë’öh
niodiya’dawë’öh	ni odi ya’dawë’ öh
ëyagojeö’	ë yago jeö ’
niyawë’öh	ni ya wë’ öh
tösayawëh	tö sa yawëh
godöhöe’	go döhöe’
wa’onoö’	wa’ o noö ’
ayoniyöök	a yo niyöö k
agadowehdahgöh	ag adowehda hgöh
de’shohigwäyë’	de’ s ho higwäyë ’
shagogedas	shago ged as
wadinëhgwi’	wadi nëhgwi ’
goksa’dayë’	go ksa’ da yë’
ye’nigöëyë’	ye’nigöëyë’
godeyagöh	go deya göh
hodiwadenyö’	hodi wadenyö ’
hoyë’	ho yë’
eodiyëdök	eodi yë dök
goswë’gaiyo’	go swë’gaiyo’
haöhwö’	ha öhw ö’
onö’ë:’	o nö’ë :’
gasdowä’	ga sdow ä’
o’giwaök	o’ g iwaök
agatöde’	ag atöde ’
eotödek	eo töde k
wa’agotödëh	wa’ ago tödë h
wa’ögwatödëh	wa’ ögw atödë h
hagatödadöh	h agatödad öh
hënöka’	hënö ka ’
ëhsnegadaia’t	ë hs negadaia’t
osde’	o sde ’
wa’agwajenöwö’s	wa’ agw ajenöwö’s
saöwödiyenöwö’s	sa öwödi yenöwö’s
ögya’dagehëh	ögy a’dageh ëh
keya’dagehënö’	ke ya’dageh ënö’
ayetiya’dageha’	a yeti ya’dageh a’
dëhsada’ënöë’	dë hs ada’ënö ë’
agadaë’öga:’	ag adaë’öga:’
hono’sgäs	ho no’sgä s
wadahset	wa dahset
o’gahset	o’ g ahset
siwahset	s iwahset
onödagöh	o nöda göh
ëgadëhö’t	ë g adëhö’ t
sadëhö’shëdö’	s adëhö’shëdö ’
gaöhjishä’	ga öhjish ä’
wadiashë:’	wadi ashë :’
sdoäk	s doäk
o’ges’ohda:’	o’ ge s’ohda :’
ika:’	i k a:’
aöëdzagaën	a öëdzaga ën
yöwökta’	yö wökt a’
oshesda’	o shesd a’
ojeänë’da’geh	o jeänë’d a’ geh
ohdadaiöh	o hdadaiöh
onö’gä’	o nö’gä ’
dejodiha’kdöh	de jodiha’kdö h
onöhšenë’öh	o nöhšenë’ öh
gonöhsot	go nöhsot
dejagonöhsot	de jago nöhsot
ganöhsodö’	ga nöhs odö’
niwënishes	ni wënishes
hëh	hëh
wë’nya’eh	w ë’nya’eh
sadöswe’danih	s adöswe’dani h
hënödowäs	hënö dowä s
dayosgowehdööje’	da yo sgowehd ööje’
öknëshayëëh	ök nëshayëë h
waodiyëh	waodi yë h
wasgwade’	w asgwade ’
ni’ah	n i ’ah
dwëniyö’da’ešöh	d w ëniyö’da’ešö h
gahäse:’	ga häse :’
ëyöiowanëök	ë yö iowanë ök
wadigowanës	wadi gowanë s
tënöhdö:’	t ënöhdö :’
hegayei’gowah	he ga yei ’ gowah
hëni’jö’	hën i’jö ’
ëgöwëni’jö:’	ë göwën i’jö :’
ne’hogwah	ne’hogwah
ënishäse’aneh	ënishäse’ aneh
gwa’	gwa’
hadiya’da:’	hadi ya’da :’
ho’gya’däje’	ho’ g ya’dä je’
ögwe’öweka:’	ögwe’ öwe ka:’
agyeönih	ag yeöni h
ogaa’	o ga a’
hadi’nön	hadi ’nön
hoyeëhdöh	ho yeëhd öh
gë’	gë’
dega’nigöëdenyös	de ga ’nigöëdenyö s
ëyekdö:’	ë ye kdö :’
da’agekdö:’	da’ age kdö :’
hadinyö’öshäeha’	hadi nyö’öshäeha ’
oweno’	o weno ’
agyöhgwanih	ag yöhgwani h
honöhwö’	hon öhw ö’
gëöshä’	gë ösh ä’
šo’ha’geh	šo ’ha’ geh
tojëtwahdöh	t o jëtwahd öh
haono’öh	ha ono’ö h
desënö’sgwak	de s ënö’sgwak
o’tënö’sgwaë’	o’t ënö’sgwa ë’
gë’dagahadenya’ta’	gë ’dagahadenya’t a’
ta’sajeh	ta’ s aje h
yëhsëtwas	y ëhsët was
ha’wëtwas	h a’wëtw as
waöwönyo’	waöwö nyo ’
ëswanyo’	ë swa nyo ’
niyögwaio’dëh	ni yögwa io’dë h
nö’gya’do’dë’	nö’ g ya’do’dë ’
ho’tgaëno’dë’	ho’t g aëno’dë ’
nigawëno’dëh	ni ga wëno’dë h
agidëöh	ag idë öh
asgwëdësek	a sgwë dës ek
nö’deyo’dë’	nö’ de y o’dë ’
yödeksowä’dahgwa’geh	yö deksowä’ dahgwa’ geh
gaganya’shä’	ga ganya’sh ä’
agënöhdö’	ag ënöhdö ’
ögwënöhdö’	ögw ënöhdö ’
da’asgwawënöyëde:’	da’ asgwa wënöyëde :’
de’jidwaiwayëdeih	de’ jidwa iwayëde ih
de’seyëöh	de’ se yë öh
wayëdei’	wa yëde i’
ëöwöyëdei’	ëöwö yëde i’
gä’tëshä’	g ä’tësh ä’
nö’gëöda’öh	nö’gëöda’ öh
niyejisdota’	ni ye jisdot a’
ögyöëdzade’	ögy öëdzade ’
ögyöëdzadenyö’	ögy öëdzade nyö’
ko’ä’geh	ko’ ä’ geh
hëhsajëëtho’	hë hsajëëtho ’
hasgatgwë’s	ha sgatgwë ’s
ho’gesgatgwëh	ho’ ge sgatgwë h
nitadiya’dageö’	ni t adi ya’dageö ’
sdëhdaëh	s dëhdaë h
agegeö’	age geö ’
hogeödö’	ho geö dö’
hagadehwëh	hag adehw ëh
waënötöwö’dih	waënö töwö’dih
hoya’dayë’hesgöh	ho ya’dayë’hesg öh
aëödiyë’he’t	aëödi yë’he’ t
hadeyësta’	h adeyëst a’
yödeyësta’shö’öh	yö deyëst a’ shö’öh
aginöh	ag in öh
ëšanitgë’t	ë š anitgë’ t
waodadë:’	wao dadë :’
degahsinön	de ga hsinön
gahsinö’geh	ga hsin ö’ geh
heyadwëdehdanih	he yadwëdehdani h
tigëöh	ti gë öh
honowëh	ho nowë h
geganëdas	ge ganëd as
niyagöho’dëh	ni yag öho’dë h
dewagehgwëh	de wage hgw ëh
deyögwahgwëöje’	de yögwa hgw ëöje’
desehgwa’t	de se hgwa’t
dëdzohate’	dë dzo hate ’
ojisda’	o jisd a’
o’gayë’gyö’	o’ ga yë’gyö ’
hodiga’has	hodi ga’h as
gönöe’s	gö nöe’ s
shagonöe’s	shago nöe’ s
deganö’net	de ga nö’net
onega’	o neg a’
ëtsadiwatödat	ët sa diwatödat
tonënökdë’	ton ënökdë ’
göhe’	g öhe ’
niënöhö’s	ni ën öhö ’s
ëganögek	ë ga nöge k
ye’jö’	ye ’jö ’
ëhsi’jöda’k	ë hsi’jöd a’k
tšiwëni’jö’	tši wën i’jö ’
jodöshot	j o döshot
onëhjih	onëhjih
niyeiwis	ni ye iwis
gagëhis	ga gëhis
o’yöshe’t	o’ yö she’ t
degegane’	de ge gan e’
dejidwagane:’	de jidwa gan e:’
dwagatgatwëh	d wag atgat wëh
datgato’	d atgat o’
hejotgatwëh	he jo tgat wëh
höwöya’dihsagöh	höwö ya’dihsag öh
sihsak	s ihsak
hatöeswe’ta’	h atöeswe’t a’
ögwahdöniaje’s	ögw ahdöni aje’s
wa’ögwahdö:’	wa’ ögw ahdö :’
agihgae’	ag ihgae ’
ji’nöh	ji’nöh
ha’dedwadahnoöhgwa’	ha’ de dw adahnoöhgw a’
oshe’nön	o she’nön
heyeyashë’	he ye yashë ’
haya’dayëdaje’	ha ya’dayëdaje’
wayadiwis’a:’	wa y adiwis’ a:’
wayatwajiyöni’	wa y atwajiyöni ’
heshedwaiwajeëto’	he shedwa iwajeëto ’
taogaën	ta ogaën
nisgwayanö’danih	ni sgwa yanö’dani h
ëyotgaeh	ë yo tgaeh
o’gagowanën	o’ ga gowanën
de’etšihšönyanih	de’ etši hšönyani h
hadeyas	h adeya s
tsadadögwe’dönyë’	ts adadögwe’döny ë’
ëhsnö’sgwahšöni’	ë hs nö’sgwahšöni ’
waënë’nigöis’a:’	waën ë’nigöis’ a:’
ëniyä’dak	ë ni yä’dak
ëgehšöni’	ë ge hšöni ’
hadijinöshö’öh	hadi jinö shö’öh
deijinöh	dei jinö h
dösagë’nyaë’	dösa g ë’nyaë’
ögwatga’de’	ögw atga’de ’
wa’agwatšisgo’	wa’ agw atšisgo ’
gayanö’döh	ga yanö’d öh
waonyak	wa o nyak
deyödä’negëhse’s	de yö dä’negëhs e’s
ha’wëtwas	h a’wëtw as
joiwa’shö’	jo iwa’ shö’
jögwadojëh	jögw adojë h
ëyonödojëöje’	ë yonö dojë öje’
gajitgweekta’	ga jitgweekt a’
odënö’geähdashä’	o dënö’geähdash ä’
o’wase:’	o ’wase :’
hodinöhgwa’shäyëdak	hodi nöhgwa’shäyëd ak
o’tënödä’t	o ’tënödä’ t
ganö’nöwëhdöh	ga nö’nöwëhd öh
godähgwänyeh	go dähgwänye h
otgi’	o tgi ’
tsa’do’döhsäëh	tsa’ do ’döhsäë h
sha’deswahsënöh	s ha ’deswahsën öh
ha’degoshäëh	ha’ de g oshä ëh
waöwönö’geë’	waöwö nö’ge ë’
sa’nigöë’	sa ’nigöë’
gahgwa’geonö’	ga hgw a’geonö’
yötgatwata’	yö tgatwat a’
oshadagöshö’	o shad agöshö’
deyögwajesdöh	de yögw ajesd öh
sa’sa’	sa’sa’
osgë’šön	osgë’šön
waënötwisdaje’nit	waënö twisdaje’nit
ëwëni’da’gegëök	ë w ëni’da’geg ëök
wadëni’do’kta’	w adëni’do’kt a’
yenesjowä’dahgwa’	ye nesjowä’dahgw a’
ono’ëh	o no’ëh
no’yëh	no’yëh
hahsowanëh	ha hsowanë h
dasatis	da s atis
hedzogëisdöh	he dzo gëisd öh
haya’dasnowe’	ha ya’dasnow e’
ëyagohdëjet	ë yago hdëjet
onya’geo’	o nya’geo ’
niyonö’net	ni yo nö’net
agejisgönih	age jisgöni h
yödënodahgwa’	yö dënodahgw a’
nö’gëödö’öh	nö’gëödö’ öh
gahsënö’	ga hsën ö’
höwöyastak	höwö yast ak
de’ohsënöyë’	de’ o hsënöyë ’
hayas	ha ya s
da’akeyasö:’	da’ ake yas ö:’
deyohsënögeh	de yo hsënöge h
oksa’datgi’shö’öh	o ksa’datgi’ shö’öh
onyaa’	o nya a’
deyodëdzoöh	de yo dëdzo öh
adehsa’	adehs a’
wase:’	w ase :’
tganödayë’	t ga nödayë ’
ganöhsak	ga nöhs ak
wak’ah	w ak’ah
wiyoaje’	w iyo aje’
niwadahsödine’s	ni w adahsödine ’s
niwahsödade’	ni w ahsödade ’
sgae’	s ga e ’
niwashëh	ni w ashë h
tiyodi’sdajeëh	ti yo di’sdaje ëh
agihgae’nih	ag ihgae’ni h
detgyei’	detgyei’ de t gyei ’
de’gähgwähgöh	de’ gä hgwä hgö h
hagöda’geh	ha göd a’ geh
de’weëh	de’ weëh
nëgëök	në g ëök
doga’ëyös’öh	do ga’ëyös’ öh
doga’ëyös’ö:’	d o ga’ëyö s’ö:’
waeyaöga’t	wa e y a öga’t
sëh	sëh
osheda’	o shed a’
onödzot	o nödzo t
ëgaiwayëdahgök	ë ga iwayëdahg ök
ganähdo’k’ah	ga nähdo’k ’ah
honödiön	honö d iö n
honeoö’	ho neo ö’
gegëhjih	ge g ëh ji h
hagëhjigëö’	ha gëh ji gëö’
tagëhjih	ta gë h ji h
gatgëhjista’	g atgëhjist a’
dwadade’gë:’	dw adade’gë :’
johihso’	j o hihso ’
yöëdza’geh	y öëdz a’ geh
heyonödagëyat	he yo nödagëyat
sgat	s ga t
dewë’nya’eh	de w ë’nya’e h
shagöhsagädih	s ha göhsagädi h
nö’dewadëdae’	nö’ de w adëda e’
onöda’geh	o nöd a’ geh
o’jehoaganëda’t	o’je hoaganëda’t
agatähdöh	ag atähd öh
oya’ë:’	o ya’ë :’
nö’gëhödih	nö’ gë hödi h
oënö’	o ën ö’
sigwah	si gwah
ogösda’	o gösd a’
hadigaweta’	hadi gawet a’
gatgonya’shä’	ga tgonya’ shä’
agahsoöh	ag ahso öh
oägwahda’	o ägwahd a’
gayadöshä’shö’öh	ga yadö shä’ shö’öh
oshöwë’	o shöw ë’
gya’däje’s	g ya’d äje’ s
ho’gya’däje’	ho’ g ya’d äje’
dödayagwat	döda yagwa t
wat	wa t
hodiähdöje’	hodi ähd öje’
deyotaögë’	de yo taögë ’
hodiwasdeisdöh	hod iwa sdeisd öh
ësgeganya’gë’	ë s ge ganya’gë ’
onëya’köshä’	o nëya’kösh ä’
gaëhdäe’	ga ëhdä e’
wa’agwatgeönö’	wa’ agwa tgeön ö’
oäwisda’	o äwisd a’
ganä’	ga n ä’
hëgëjohgwiyoaje’	hë gë johgwiyo aje’
deyohsaihdae’	de yo hsaihda e’
waöwödiögohdë’	waöwöd iö gohd ë’
waënödiwahdëja’t	waënö d iwa hdëja’t
o’gä’teh	o’ g ä’te h
hënögweh	hën ögwe h
honösgwayë’	honö sgwa yë’
tganödayë’gowah	t ga nöda yë’ gowah
hënöyagwas	hënö yag was
wa’ögegwat	wa’ öge gwat
dagek	da g ek
gaya’da:’	ga ya’da :’
gisgwis	gisgwis
hoiwanodaje’	ho iwanod aje’
onöhi’gaa’	o nöhi’ga a’
onöhgwë’doa’	o nöhgwë’doa ’
osowa’da’	o sowa’d a’
agidëöh	ag idë öh
ësgwëdësek	ë sgwë dë sek
ha’dekedëje’	ha’ de ke dë je’
deyaoöh	de y ao öh
de’gyëtwas	de’ g yët was
agyëtwa’öh	ag yëtwa’ öh
niyot’eohdageh	ni yo t’eohdage h
gawisdanoö’	ga wisda noö ’
ënötganya’t	ë nö tganya’t
waënötganye:’	wa ënö tganye :’
wa’agyatganye:’	wa’ agy atganye :’
awëdetgäde’	a w ëdetgäd e’
ënödö’eshö:’	ë nö dö’eshö :’
ëodi’nigöiyoak	ë odi ’nigöiyo ak
gatgwa’da:’	ga tgwa’da :’
gëeh	gë e h
o’gwagahdë’	o’ gwa gahd ë’
ëjöwödë’	ë jöw öd ë’
waonöjanö’k	wa onö janö’ k
waeyë’nyo’gat	wae y ë’nyo’gat
deyesdäte’dahgwa’	de ye sdäte’dahgw a’
wa’ödëhsö:’	wa’ ö dëhsö :’
onëhsöhgwa’	o nëhsöhgw a’
gisgwisgëö’	gisgwis gëö’
ëgegweni’	ë ge gweni ’
da’agagweni’	da’ aga gweni ’
dëtgagweni’	dë t ga gweni ’
ganö’dza’	ga nö’dza ’
onönö’da’	o nönö’d a’
ëtsete’t	ë t se te’t
ohdönyö’shä’	o hdönyö’sh ä’
getahas	ge tahas
niganoö’	ni ga noö ’
deyeya’danet	de ye ya’danet
hadinönyöta’	hadi nönyöt a’
ësnyadehšönyanö:’	ë sny adehšönyanö :’
agadehsa’öh	ag adehsa’ öh
ëhsades’a’	ë hs ades’ a’
yeya’dade’	ye ya’dade ’
nitgade’	ni t ga de ’
agoägöh	ag oäg öh
nigageo’dëh	ni ga geo’dë h
niwadoshine’s	ni w adoshine ’s
wa’ögwayeih	wa’ ögwa yei h
dwatgwëë’	dw atgwë ë’
dewa’ha:’	de w a’ha :’
o’keyatga’	o’ ke y atga’
shögwatga’wëh	shögw atga’ wëh
deyotši’sgweh	de yo tši’sgwe h
hodinyodagwëh	hodi nyodag wëh
hodi’se’	hod i’se’
dasajëtoh	da s ajëto h
odaga’dahgöh	o daga’dahg öh
gaista’	ga ist a’
waënöt’ahšodaah	waënö t’ahšodaah
agegë’sähgöh	age gë’sähg öh
hadewata’	h adewat a’
hadewatha’	h adewat ha’
o’tadiyë:’	o’t adi yë :’
hegayë’	he ga yë ’
da’detgayë’	da’ de t ga yë ’
o’gya’dadat	o’ g ya’dadat
ëhsoh	ë hs oh
waënödaah	waënö daah
watgehdat	wa tgehdat
ëödigëyadë’	ë ödi gëyadë ’
ho’wënöja’dawetäh	ho’ wënö ja’dawetäh
o’tgëhsowek	o’t g ëhsowek
hodiyäje’	hodi yäje’
waë’	wa ë’
agodahöh	ag odahöh
wa’eö’	wa’ e ö’
ësejihnya’hödë’	ë seji hny a’hödë’
dewagä’negësdöh	de wag ä’negësd öh
akdadöh	ak dad öh
dzo’gäö’	dzo’gäö’
sgashe’dih	s ga she’di h
ganya’kaö’	ga nya’kaö ’
sawënihë:’	sa w ënihë :’
oënö’	o ënö’
waönishädëhda:’	wa önishädëhda :’
waöni’shä’geh	wa öni’sh ä’ geh
o’gasdaëto’	o’ ga sdaëto ’
osdägi’	o sdägi ’
otägwahgwëh	o tägwahgw ëh
gano’sgäe’	ga no’sgäe ’
sigwëön	sigwëön
hewagenyatgäöh	he wage nyatgä öh
hadeyësta’	h adeyëst a’
yödeyësta’shö’öh	yö deyëst a’ shö’öh
dogës	dogës
de’swaiwa’	de’ swa iw a’
shagoyewata’	shago yewat a’
o’gadiyök	o’ g adiyök
dösashedwanöönyö:’	dösa shedwa nöönyö :’
edwanönyö:’	e dwa nönyö :’
aknehös	akn ehös
heyonök	he yo nök
ëhsatga’	ë hs atga’
waöwënötga’	waöwënö tga’
gä’gaehgöh	g ä’gaehg öh
agashä’šönyöh	ag ashä’šönyö h
nëwögashaa’t	në wög ashaa’ t
ëöwöshaa’t	ëöwö shaa’t
hogëhdëöh	ho gëhdë öh
agö’nöh	ag ö’n öh
ësgyadatewat	ë sgy adatewat
o’gadöišök	o’ g adöišök
o’tgyeödaak	o’t g yeöd aak
hodiwayëdahgöh	hod iwayëdahg öh
dëge’nyaë’	dë ge ’nya ë’
shokdöh	s ho kd öh
onähdowanës	o nähd owanës
waotganöni’he’t	wa o tganöni’he’ t
agehse’	age hse ’
hodi’se’	hodi ’se ’
onöwëhdöh	o nöwëhd öh
hegayei’	he ga yei ’
detgyei’	det g yei ’
ojiyaih	o jiyai h
ho’gaih	ho’ ga i h
ëgëhödenyöök	ë gë hödenyö ök
oadaje’	o adaje’
wade’sgödak	w ade’sgöd ak
agadöwida’döh	ag adöwida’d öh
yötöwögahadöta’	yö töwögahadöt a’
hayok	hayok
gëhsade’	gë hsade ’
otgë’öh	o tgë’ öh
dojo’hagwe’nönih	d o jo’hagwe’nöni h
sëh	sëh
dzohgwe’eani’	dzohgwe’eani’
o’tknöhdai’	o’t k nöhdai ’
wade’go’	wa de’go ’
sayagyade’go’	sa yagy ade’go ’
hewakdakenöh	he wak daken öh
tënë’sga:’	t ënë ’sga :’
o’tëhdat	o’t ëhdat
yedake’	ye dake’
ëyedake’	ë ye dake’
ho’nigöetgëta’	ho ’nigöetgët a’
ojike’da’	o jike’d a’
owänögi’	o wänögi ’
de’shodi’nigöiyoh	de’ shodi ’nigöiyo h
o’tögot	o’t ögot
hahsönye’s	ha hsöny e’s
o’wëös	o’ w ëös
yadöh	y adö h
gësdae’	gë sda e’
o’töwödinöek	o’t öwödi nöek
waenönyani’	wae nönyani ’
wa’ögyahjök	wa’ ögy ahjök
wa’ohjöte’t	wa’ o hjöte’ t
o’jödogwat	o’jö dogwat
wagi’daswaëh	wag i’daswaë h
shagogedas	shago ged as
yegeda’ta’	ye geda’t a’
dewagahjiyos	de wag ahjiyo s
dawëëdö’	da w ëëdö ’
siwahset	s iwahset
o’tšadadegë’	o’ tš adadegë ’
ae’	ae’
aöwögë’	aöwögë’ a öwö gë ’
de’shadidoka’	de’ shadi dok a’
gadi’geah	gadi’geah
aënödëninö’	a ënö dëninö ’
shogë’dzowa:’	s ho gë’dz owa:’
hënödekönya’ta’geh	hënö dekönya’t a’ geh
o’takahsi’	o’t a kahsi ’
nö’deyagyade’	nö’ de yagy ade ’
nagwas’öweh	nagwas’öweh
waënöhsödöni’	waënö hsödöni ’
hënöwödë’	hën öwöd ë’
waënötšisdayë:’	waënö tšisdayë :’
ökdogës	ök dogës
o’wënöwöyë:’	o’ w ënöwöyë :’
tëni’jö’	t ën i’jö ’
hëgöwëni’jö’	hë göwën i’jö ’
onyo’gwa’	o nyo’gw a’
niwashëh	niwashëh
ga’niköshä’	ga ’nikösh ä’
odëönoshägöh	o dëönosh ägöh
gai’doö’	ga i’doö ’
akyagahiyö’	ak yagahiyö ’
ganigëöshä’	ga nigëösh ä’
okda’	o kd a’
ohdahgwa’	o hdahgw a’
waöwö’no’yak	waöwö ’no’yak
hënödëninösgowah	hënö dëninö s gowah
niwak’ah	ni w ak’ah
onëhsa’	o nëhs a’
deyoeta’	de yo et a’
ëyododahsi’	ë yo dodahs i’
agadi’gyö’	ag adi’gyö ’
ke’gë’shö’öh	ke ’gë’ shö’öh
deyagwadënöde:’	de yagw adënöde :’
agyajoh	agy ajoh
waonöökdë’	wa o nöökdë ’
öknöhsodai’	ök nöhsodai ’
o’gawak	o’ g awak
onöni’da’gowah	o nöni’d a’ gowah
hodöön	ho döö n
wa’agwadënodönyö:’	wa’ agw adënodönyö :’
hadënota’	h adënot a’
yödeksowä’dahgwa’	yö deksowä’ dahgwa’
saënöjë:’	sa ënö jë :’
da’agajë:’	da’ ag ajë :’
genyohšot	ge nyohšot
ësninyohšodaje’sek	ë sni nyohšod aje’sek
sgat	sgat
niyohsodza’	ni yo hsodza ’
deyewë’geodahgwa’	de ye wë’geodahgw a’
ga’šohsa’	ga ’šohs a’
ëgyëse:’	ë g yëse :’
ëgëöyadek	ë gë öyade k
gaeyo’dza’	ga eyo’dz a’
wa’agoda’	wa’ ago da’
gashewë’da’	ga shewë’d a’
agadohsä’seh	ag adohsä’se h
sgënö’öh	s gë nö’öh
de’ostöh	de’ ost öh
oji’nöwö’	o ji’nöw ö’
niwa’s’ah	ni w a’s’ah
onösgwëödöh	o nösgwëödö h
agesënöswas	age sënöswa s
agyödih	ag yödi h
ho’wajë’gweodö:’	ho’ w ajë’gweodö :’
dewage’tsösta’	de wage ’tsöst a’
ga’nöwöhdas	ga ’nöwöhdas
gagoswa’geh	ga goswa’ geh
saganiyayë:’	sa ga niyayë :’
gatgwiä’geh	ga tgwi ä’ geh
ähdak	ähdak
heyönëdahgwa’	he yönë dahgw a’
oägwahda’	o ägwahd a’
ogë’öh	o gë’ öh
owëhde’	o wëhd e’
gaënödogëh	ga ënödogë h
goswe’nönöwös	go swe’nönöw ös
onegagi’	o negagi ’
hodinökdot	hodi nökdot
wa’esnye’šö’	wa’ e snye’šö ’
gowënitgë’öh	go wënitgë’ öh
gawënitgë’ö’	ga wënitgë’ ö’
ëtadisnye’t	ët adi snye’t
higë’	higë’
waënöet	wa ënöet
oi’shä’	o i’sh ä’
haihsönyöh	ha ihsönyö h
agesje’sä’geh	age sje’s ä’ geh
dewagowë’	de wag owë ’
adogwa’šowanëh	adogwa’šowanë h
yo’gëö’	yo’gëö’
ëyagohga:’	ë yag ohga :’
ëhsete’šyohga:’	ë hse te’šyohga :’
ëyonegitgëhsöök	ë yo negitgëhsö ök
dwadiyagë’s	dwadi yagë’ s
onya’sa’	o nya’s a’
dzo’kdagö’	dzo ’kdagö’
tšigähgöh	tši g ähg öh
wa’gohsodö’	w a’gohsodö ’
daja’tgwaihsi’	d aja’tgwaihs i’
dëyeda’t	dë ye da’ t
iget	i ge t
jedaje’s	j e d aje’s
tsa’gat	tsa’ ga t
gajihsö’dahsia’	ga jihsö’dahsia ’
wagadëyogwahdë’	wag adëyogwahd ë’
gi’jö’	g i’jö ’
ëtëni’jöda’k	ë tën i’jö da’k
hësgi’jöda’k	hës g i’jö da’k
aknösgwëh	ak nösg wëh
onödes	o nödes
hashëda’s	h ashëda’ s
haknö’is	hak nö’is
ëhsä’nëdak	ë hs ä’nëdak
ga’nhya’	ga ’nhy a’
otšinönösgä’	o tšinönösg ä’
dewawënyeh	de w awënye h
otgwisda’	o tgwisd a’
ogöhga’shä’	o göhga’sh ä’
sawënihë:’	sa w ënihë :’
saë’he’t	sa ë’he’ t
joë’hesta’	jo ë’hest a’
sadewadëh	s adewad ëh
godetgihdöh	go detgihdö h
de’gagä:’	de’ ga gä :’
hedogëh	he dogë h
odagwaihsöh	o dagwaihs öh
hënödayohse’	hënö dayohs e’
ögwaya’daniyehgöh	ögwa ya’daniyehg öh
ëyetšinö’dza’es	ë yetši nö’dza’es
otgöwö’sägi’	o tgöwö’sägi ’
onöwëhdöh	o nöwëhd öh
wade’jiata’he’t	w ade’jiata’he’ t
ha’hasde’	ha ’hasde ’
tsa’deyagi’hasde’	tsa’ de yagi ’hasde ’
o’jagwadogëh	o’j agwa dogë h
hwagödoda’t	h wa gödoda’t
gashesda’	ga shesda ’
ogösäse:’	o gösäse :’
jögwa’öh	jögwa’öh
agadiwayeösdöh	ag adiwayeösdö h
o’jogëhödi’	o’j o gëhödi ’
hwa’akinök	h wa’ ak inök
gähgwa:’	g ähgwa :’
awëdadogëhdöhgeh	aw ëdadogëhd öh geh
ho’gähgwë’t	ho’ g ähgwë’ t
wa’ökniwanägo’	wa’ ökn iwanägo ’
haisdi’šös	ha isdi’šö s
hëönegönën	hëö negönën
o’daiëshä’	o ’daiësh ä’
owänöe’	o wänöe ’
onöhwë’da’	o nöhwë’d a’
wëödenya’ta’	w ëödenya’t a’
högidës	hög idë s
wagidë:’	wag idë :’
asgidë:’	a sg idë :’
wahjawee’	wahjawe e’
wadi’sehdadahgo’	wadi ’sehda dahgo ’
gotwa’isdanö’	go twa’isdanö ’
dëyögwadadesnye:’	dë yögw adade snye :’
o’jögesnye:’	o’j öge snye:’
dëgesnye:’	dë ge snye :’
wa’ödënö’t	wa’ ö dënö’t
tsa’giwasdeis	tsa’ g iwasdeis
agega’tsöh	age ga’ts öh
hënödënö’dëöje’	hënö dënö’d ëöje’
haogwëh	ha og wëh
yedahgwa’	ye dahg wa’
ëtadiägwat	ët adi ägwat
dayökihe’	da yöki he’
segoh	se goh
wa’ego’	wa’ e go’
wadia’	wadi a’
ëöö’	ëö ö’
o’jagwatëönyö:’	o’j agwa tëönyö :’
ëöwöditahas	ë öwö ditahas
ëswënödi’sdaë’	ë s wënö di’sdaë’
jota:’	j o ta:’
degataha’	de ga taha’
nigaëes	ni ga ëes
gashenë’	ga shenë ’
oga’öshö’öh	o ga’ö shö’öh
ëyekdö:’	ë ye kdö :’
da’agekdö:’	da’ age kdö :’
ësgwayësdë’	ë sgwa yësdë ’
wa’ökiönyë’	wa’ ök iönyë ’
hajönyanih	ha jönyani h
niwadogwa’shä’ah	ni w adogwa’shä’ah
o’göowi’	o’ gö owi ’
wa’ökiowi’	wa’ öki owi ’
wa’akniowi’	wa’ akni owi ’
ëshatšonyanö:’	ë s h atšonyanö :’
satšonyanöh	s atšonyanö h
eyatšowi’	ey atšowi ’
ëyagwatšowi’	ë yagw atšowi ’
hëneyö’	h ëneyö ’
hakyönyanöh	hak yönyanö h
washëh	washëh
ëhsnegakdö:’	ë hs neg a kdö:’
sekdöh	se kdö h
o’höhsa’	o’ höhs a’
ehniwagwaihsi’	ehn iwagwaihs i’
o’jakinönyö:’	o’j aki nönyö :’
dëödinönyö:’	dë ödi nönyö :’
dënödënöönyöh	d ënö dënöönyö h
högwagwah	högwagwah
snö’nöwën	s nö’nöwë n
onëh	onëh
gyahda’geh	g yahd a’ geh
ho’nëyatëh	ho ’nëyatë h
joiwa’	j o iw a’
agweh	agwe h
wa’ë:’	wa’ ë :’
gënöhdönyöh	g ënöhdönyö h
ënënöhdönyök	ënë nöhdönyö k
sgae’	sgae’
sëh	sëh
onöni’da’	o nöni’d a’
nigawisdageh	ni ga wisdage h
yenya’sagöh	ye nya’s a göh
ëöwöehda’is	ë öwö ehda’is
wa’odi’	wa’ o di ’
oyöhgä:’	o yöhgä :’
geih	geih
ögwagonyës	ögwa gonyës
ho’gae’	ho’ ga e’
waeh	waeh
gaisdatgos	ga isdatgo s
niyu’uh	ni yu’ uh
waatsën	wa atsën
niahsënot	ni a hsënot
kyagwiyä’	k yagwiy ä’
niwënödih	ni wënö di h
oyakaö’	o yakaö ’
so’jih	so’jih
gaëgëyat	ga ëgëyat
ayoiwadaje’	a yo iwad aje’
o’jeksa’da:’	o’j e ksa’da :’
dešeönyöh	de š eönyö h
o’tšeönyö:’	o’t š eönyö :’
ha’dayeönyö:’	ha’dayeönyö :’
eodiya’daniyöök	eodi ya’daniy öök
higëgwah	higëgwah
wënötöwisas	wënö töwisas
atganye’shä’	atganye’sh ä’
dewagadadawih	de wag adadawi h
ga’sehdayanowe’	ga ’sehda y anowe’
degwënö’sägwas	de g wënö’sägwas
aknösde’	ak nösde ’
hëöja’s	hë öja’s
gäida’geh	g äida’ geh
gaiwagwëniyo’	gaiwagwëniyo’
sadënö’geät	s adënö’geät
waakdö:’	wa a kdö :’
ëökdö:’	ë ö kdö :’
dënö’ëniyas	d ënö ’ëniya s
wayatwadase’	wa y atwadase ’
watgaëgo’	wa tgaëgo ’
dödadihsadeni’	död adihsadeni’
jodägwëh	j o dägwëh
ëye’nigöëgaëgo’	ë ye ’nigöëgaëgo ’
honyahdëh	ho nyahdëh
dasgeowë’	dasgeowë’
deknih	deknih
dewë’nya’eh	dewë’nya’eh
tonë’neo’k	t on ë’neo’k
o’go’soägo’	o’ g o’soägo ’
sa’nigöëyëda’s	sa ’nigöëyëda’s
esa’nigöëyëda’t	e sa ’nigöëyëda’t
nö’göka:’	nö’göka:’
onösä’ah	o nösä’ ah
niahsöhgäs’ah	ni a hsöhgäs’ah
he’tgëgwah	he’tgëgwah
i:’	i:’
hëyago’kdahgwak	hë yag o’kdahgwak
dëyotwe’nöniak	dë yo twe’nöniak
eotäk	eo täk
waotganya’gak	wa o tganya’gak
hënöjä’dahgwa’	hënö jä’dahgwa’
ëyojä’dahgöök	ë yo jä’dahgöök
hojä’döje’	ho jä’döje’
dwayä’ta’	d wa yä’t a’
de’wadesta’	de’ w adest a’
yöwëödahgwa’	yö wëödahgw a’
hodijigwës	hodi jigwës
ähdak	ähdak
o’öhsa’	o ’öhs a’
wa’ogë’te’t	wa’ o gë’te’ t
hagyö’seh	hag yö’se h
ëhsatši’gwato’	ë hs atši’gwato ’
sadiöganya’k	s adi öganya’k
o’tënöde’säë’	o’t ënö de’sä ë’
dehšya’ja’göh	de hš ya’ja’g öh
wa’eyeh	wa’ e ye h
hohso’gane’	ho hso’gane ’
ögweh	ögwe h
dagatak	da g atak
gëhsagöh	gë hs agöh
ojisda’geh	o jisd a’ geh
wënödasganekönyöh	wënö dasganekönyö h
deyagodöëdzonih	de yago döëdzoni h
o’tonödöëdzos	o’t onö döëdzos
ëgadiyoshä’	ë g adiyosh ä’
ësganenönyö:’	ë s ga nenönyö :’
sayo’daiëh	sa yo ’daië h
hodisgë’ëgehda’	hodi sgë’ëgehd a’
sadëhsi’dowaeh	s adëhsi’dowae h
ëhsnowae’	ë hs nowae ’
ögwatši’wa:’	ögwa tši’wa :’
ögatši’waë’	ög atši’waë ’
ëhsatši’wato’	ë hs atši’wato ’
ha’dadigane:’	ha’ dadi gane:’
agatgaëö’	ag atgaëö ’
ëjatgaëö’	ëj atgaëö ’
ëhsatgaëök	ë hs atgaëö k
tganegiyosta’geh	t ga negiyost a’ geh
wa’öde’sgo’	wa’ ö de’sgo ’
agedzëöh	age dzëöh
onega’geh	o neg a’ geh
agëdöh	ag ëdöh
de’o’dëh	de’ o’dë h
gadageeyös	ga dageey ös
hënödiyosdahgwa’	hënö diyosdahgw a’
heyöjä’ta’	he yö jä’t a’
hodisdowëö’	hodi sdowëö ’
ogeo’dza’geh	o geo’dz a’ geh
dëjihnyadadegë’	dëji hny adadegë ’
deyaögoh	de ya ögo h
nö’geyëno’dë’he’t	nö’ ge yëno’dë’he’ t
o’nisgä:’	o ’nisgä :’
gaweh	gaweh
nö’we:’	nö’we:’
onögä:’	o nögä :’
onëögën	o nëögën
hanyö’öh	ha nyö’ö h
ga’sgwägëën	ga ’sgwägëën
tšiša’dagwegöh	tši š a’dagweg öh
ei’	ei’
hadinyo:’	hadi nyo :’
otgwenyöh	o tgwenyö h
niwatgwenyös	ni w atgwenyös
o’gadë’nea’	o’ g adë’nea ’
osgowehdöh	o sgowehd öh
wa’egaehdawak	wa’ e gaehdawak
oshägwegöh	o shägweg öh
hägöewas	h ägöew as
dewagadënön	de wag ad ënön
honötgö’shö’öh	honö tgö ’ shö’öh
yeöh	ye ö h
tšiwadiwajiyägeö’	tši w ad iwa jiyä geö’
tehdoö’	tehdoö ’
o’gaiwë’t	o’ ga iwë’ t
heyodiwinöh	he yo diwin öh
de’swagajo’dadö:’	de’ s wag ajo’dad ö:’
wagyöyagë’t	wag yöyagë’t
ögwaio’de’	ögwa io’de ’
gahgwasta’	g ahgwast a’
dëyadajenö:’	dë y adajenö :’
os’ohda’hön	o s’ohda ’hön
hayadö:’	ha yadö :’
watähgwë’gwata’	w atähgwë’gwat a’
ëh	ëh
haksa’dase’ah	ha ksa’dase ’ah
tšigögwe’dase:’	tši gö gwe’dase :’
höwëdës	höwëdës
niyowe’	ni yowe ’
dëdwaganëgöh	d ë dwa ganëgö h
o’ënöeta’	o’ ë nöet a’
o’wajowi’	o’ w ajowi ’
swadiwahdëja’ta’	sw ad iwa hdëja’t a’
aesknigë’	ae sk nigë ’
ëhnënö’geät	ë hn ënö’geä t
wa’agwadekönyanö’	wa’ agw adekön yanö ’
ho’gat	h o’ g a t
igya’s	i gy a’ s
hiyëdeih	hi yëdei h
ësnowae’	ë s nowae ’
aehnidë:’	ae hn idë :’
aknyadöh	a knyadö h
o’watak	o ’w ata k
deodinösde’	d eodi nösde ’
shagoawi’	shago awi ’
ëwötganya’t	ë wö tganya’ t
dëwötak	d ë wö ta k
wa’ago’nigöetgë’t	wa’ ago ’nigö etgë’ t
ëgadawë’	ë g adawë ’
wa’onötgato’	wa’ onö tgato ’
wa’odigayëh	wa’ odi gayë h
dëyötak	d ë yö ta k
niyono’sgägeh	ni yo no’sgä geh
höwöya’dagwëniyosdöh	höwö ya’d ag wëniyosdö h
ëyatganye:’	ë y atganye :’
o’geyë’he’t	o’ ge yë’ he’ t
esgwashe:’	e sgwa she :’
hagönöe’öh	hagö nöe’ öh
watganya’ta’	w atganya’t a’
ësgänye:’	ë s g änye :’
ëödigo’	ë ödi g o’
wa’ökninöe’t	wa’ ök ninöe’ t
ayaknishe:’	a yakni she :’
sajä’dak	s ajä’da k
hane’sek	h a n e’s ek
agwanöhsot	agwa nöhsot
agadöišöhgöh	aga döišöhg öh
ëjidwayëtwashö’	ë ji dwa yë twa shö ’
ga’sgöwö’	ga ’sgöw ö’
ayögwënöhdök	a yögw ënöhdö k
o’snidë:’	o’ sni dë :’
gahadot	ga hadot
ayögidë:’	a yög idë :’
asegwa’	a se gwa ’
hagowanës	ha gowanë s
nitgade’	ni t ga de ’
aënödiwatödat	a ënö d iwa tödat
ëyagwajë:’	ë yagwa jë :’
wa’agwëdzoyak	wa’ agw ëdzoya k
nigyëdiak	ni g yëdia k
o’jakninönyö:’	o’ j akni nönyö :’
deodisnyenö’	d eodi snyenö ’
aeshedwashe:’	ae shedwa she :’
ëwënödahset	ë wënö d ahse t
wa’ehodö:’	wa’ e hodö :’
ësnië’	ë sni ë ’
gajeä’ta’	ga jeä’t a’
ëšadö’	ë š adö ’
ökyowih	öky owi h
akeninö’s	a ke ninö ’s
ëyades’a:’	ë y ades’ a:’
aöwöyëdei’	a öwö yëdei ’
owë’öje’	o wë’ö je ’
dohga:’ah	dohga:’ah
oyëdedöje’	o yëded ö je’
awadihšöni’	a wadi hšöni ’
dadaiwayeis	d ada iwa yeis
ayaknyatgweni’	a yakny at gweni ’
’nigëöwënye:’	’nigëö wënye :’
dawadiya’dowet	da wadi ya’dowet
ëwögida’	ë wögi da ’
ahsata’dö:’	a hs ata’dö :’
o’gyatga’	o’ gy atga ’
wadiwisdo’yak	w adi wisd o’yak
ësgyësdë’	ë s g yësdë ’
dayagyadiak	d a yagya di ak
saganöhe’t	sa ga nöhe’t
höwöya’dagehas	höwö ya’d a gehas
wa'aknyatšonyanö:’	wa' akny atšony anö :’
agatgato’	a g atgat o’
wa’edzagö’	wa’ e dzagö ’
tga’sgweodö’	t ga ’sgweodö ’
dëwödiyenö:’	d ë wödi yenö :’
ëhsešnye’t	ë hse šnye’ t
wadiyeä’dak	w adi yeä’dak
wayade’nöhdäh	wa y ade’nöhdä h
akninösgo’	a kni nösg o’
niyo’dëök	ni y o’dë ök
dëöwödiyenö:’	d ë öwödi yenö :’
wënöta’dös	wënö ta’dö s
dawadetgit	d a w adetgit
awadaödö:’	a w ada ödö :’
oiwa’	o iwa ’
ëgoowi’	ë go owi ’
o’tšahsëto’	o’ tš ahsët o’
ësnihodö:’	ë sni hodö :’
ëödiyëto’	ë ödi yëto ’
o’sheswaya’dageha’	o’ sheswa ya’d a geha ’
waiya’k	w a iya’ k
dwadigëhjishö’öh	dwa di gëhji shö’öh
sahdëje’s	sa hdëje’ s
gowëh	go wë h
ëtkeyawi’	ë t ke y awi ’
waögya’dageha’	wa ög ya’d a geha ’
dayatgëh	d a y atgë h
yewajiyäyë’	ye wajiyä yë’
ëhnidë:’	ë hn idë :’
akniadö:’	a kni adö :’
hadojas	h adojas
dëwënöhsëto’	d ë wënö hsët o’
wajënöni’	w ajënöni ’
hojëösgö’	ho jëösgö ’
dewajisdöh	de w ajisdö h
swaya’s	swa ya’ s
ëswatowät	ë swa towät
awënödahset	a wënö dahset
o’tkninöönyö:’	o’ t kni nöö nyö :’
hodinonö’ëh	hodi nonö’ë h
aöwëdë:’	a öwë dë :’
nëdah	nëdah
tayaknigë	t a yakni gë ’
dwadojas	dwa dojas
dehnidenyös	d e hni denyö s
wonida’	w oni da ’
ësëniso’	ë s ëniso ’
aënödënodë’	a ënö dënod ë’
waehša’dageha’	wa ehš a’d a geha ’
oa’da’	o a’da ’
oga’öhšöh	o ga’öhšö h
waönöhsës	wa ö nöhsë s
wa’onödi’	wa’ onö di ’
jögwahdëjös’öh	j ögw ahdëjös’ öh
waöwënidë:’	wa öwën idë :’
nö’dedwade’	n ö’ de dwa de ’
dayagyadiak	d a yagya di ak
howöowih	howö owi h
hadiashëö’	hadi ashë ö’
ayodiya’dageha’	a yodi ya’d a geh a’
ëgadešönyanö’	ë g ade šön yanö ’
dogwa’	dogwa ’
ëwënödawë’	ë wënö dawë ’
ëöyö’	ëö yö ’
dëša’dowet	d ë š a’d owe t
ëgiwaies	ë g iwa ies
esnyahsawë’	e sny ahsawë ’
aënödeyës	a ënö deyës
wanösgo’	w a nösg o’
ëhse’nikönyö:’	ë hse ’nikö nyö :’
hösaya’dagehas	hösa ya’d a geh as
ëhniyënëda’t	ë hni yënëda’ t
ödawënödawën	öda wënö dawën
aedwatgweni’	ae dw at gweni ’
ösayeyagë’t	ösa ye yagë’t
to’nyöda’döh	t o ’nyöda’d öh
agwashe:’	agwa she :’
knöwö’s	k nöwö’s
ëdwata’dö:’	ë dw ata’dö :’
oyë’he’öh	o yë’he’ öh
wa’ödošök	wa’ ö došök
yagwe’s	yagw e’s
ëyënö’geät	ë y ënö’geä t
sawadiät	sa wa diät
agwawi’	agwa wi ’
goneoö’	go neo ö’
ayatgweni’	a y at gweni ’
agatowinyö’seh	ag atowinyö’se h
ni:’ah	n i:’ ah
gëhöde’	g ëhöde ’
aeswahsawë’	ae sw ahsawë ’
sawadäshäga’tši’	sa w adäshäga’tši ’
dega’nöshë’	de ga ’nöshë’
swasgatgwë’s	swa sgatgwë’ s
odiya’dagehëh	odi ya’d a geh ëh
gaëdi’gwah	ga ëdi’gwah
dëyökinönyö:’	d ë yöki nönyö :’
oähdö’geh	o ähdö’ geh
ähgwawänöe’	ähgwawä nöe ’
wa’aknihšöni’	wa’ akni hšöni ’
yödeyësta’	yö deyës ta’
agwaiwayë’	agwa iwa yë’
onöhgwë’da’	o nöhgwë’d a’
ënënöhdönyö:’	ën ënöhdönyö :’
yeowih	ye owi h
aknyatgwenye’s	akny atgwenye’ s
honënöedöh	hon ënöedö h
ëdwa’hödë’	ë dw a’hö dë’
ashögwagë’	a shögwa gë ’
wodiya’dayeih	wodi ya’d a yei h
ëyodinöe’t	ë yodi nöe’t
aonöe’t	a o nöe’t
agajënöni’	a g ajënöni ’
aknyadowis	akny adowi s
aödiögohdë’	a ödi ögohd ë’
ënöete’s	ënö ete’ s
waešenö’	wa e šenö ’
hayagwe:’	h a yagw e :’
yajënönih	y ajënöni h
ëwö’hödë’	ë wö ’höd ë’
isah	i s ah
wäh	wäh
nöwënöjë’s	n ö w ënöjë’ s
yögeowih	yöge owi h
wahsawë’	w ahsawë ’
hadiya’tgëh	hadi ya’tgë h
goya’dayeisdahgwa’	go ya’d a yeis dahgwa’
nionyö’öh	ni onyö’ öh
ëdwajo:’dat	ë dw ajo:’dat
naesnyaje:’	n ae snyaje :’
de’wajo’das	de’ w ajo’das
onösgä’	o nösg ä’
ayesëdë:’	a yesë dë :’
ëyötganye:’	ë yö tganye :’
yadaöhdiyosta’	y adaöhd iyos ta’
hagögëyadanih	hagö gëyadani h
waënënishäyeöni’	wa ë nishä ye öni ’
naöwöya’dageha’	na öwö ya’d a geha ’
ne'hojih	ne'ho jih
esnyades’a:’	e sny ades’a :’
nigiwayëdeih	ni g iwa yëdei h
ayaknyahsawë’	a yakny ahsa wë ’
dëgyatak	d ë gy ata k
nëgës	n ë g ës
ëšëdiak	ë š ëdi ak
dekni’jö’	de kn i’jö’
nioyeëh	ni o yeë h
odiyëönö’	odi yëö nö’
ayöhsoh	a yö hso h
hojanön	ho janön
o'sesnye’	o' se snye’
wa’eiwahset	wa’ e iwa hset
swajëök	sw ajëö k
ho’kne:’	ho’ kn e:’
etiyade’	eti yad e’
nö’odiya’dawëh	nö’ odi ya’d a wë h
o’ya’shö’	o’ya’ shö’
agwanöge’	agwa nöge ’
wa’agwatšowi’	wa’ agw atšowi ’
hëhšö’	h ë hš ö ’
wënödaöhdiyosta’	wënö daöhd iyos ta’
hadiyenös	hadi yenö s
gonösde’	go nösd e’
aöwödishe:’	a öwödi she :’
ëyaknyatšonyanö:’	ë yakny atšon yanö :’
ëshagonöe’t	ë shago nöe’ t
hodiyei’önö’	hodi yei ’ö nö’
nagaye:’	n a ga ye :’
hadiya’kö’	hadi ya’k ö’
onë’dagöh	o në’da göh
dodöëdzonih	d o döëdzoni h
ähgwa’shö’öh	ähgwa ’shö’öh
ëigweni’	ë i gwen i’
agwënö’geäta’	agw ënö’geä ta’
ëyögwëhnödönyoök	ë yögw ëhnödönyo ök
dodawënyeh	d o dawënye h
da’ösawagida’	da ’ösa wag ida’
niyoiwageh	ni yo iwa geh
akeshe:’	a ke she :’
satgato’	s atgat o’
o’wadegwat	o’ w ade gwat
onyeä’	o nyeä’
gwa’hoh	gwa’hoh
ëhsidë:’	ë hs idë :’
ojihsö’da’	o jihsö’d a’
ëhsatgato’	ë hs atgat o’
dawënöhdö:’	d a w ënöhdö :’
ye’howekta’	ye ’howekt a’
dwahsödekshö’öh	d w ahsöd ek shö’öh
aehniya’dageha’	ae hni ya’d a geh a’
o’wagatgato’	o’ wag atgat o’
hodiöwö’shö’öh	hodi öwö’ shö’öh
waiowi’	wa iowi ’
o’tgadögot	o’t g adögot
swayë’he’öh	swa yë’he’ öh
hatgwenye’s	h at gwenye’s
niwe’s	ni we’s
deswawënyes	de swa wënyes
ogahgwä:’	o gahgwä :’
swatgëös	sw at gëö s
gaekëöshä’	ga ekëö shä’
ëswadoishë:’	ë sw ad oi shë :’
ökniya’dagehëh	ökni ya’d a gehë h
edwanösgo’	e dwa nösg o’
ayaknyadeköni’	a yakny ade köni ’
ahsnöe’t	a hs nöe’ t
ëwödahgwi’	ë wö dahgwi ’
shadiyanöhsia’	s hadi yanöhsia ’
ëyetiewat	ë yeti e wat
ayesanöe’t	a yesa nöe’ t
aesniyënëda’t	ae sni yënëda’ t
waënödahset	waënö da hset
ëösanöe’t	ë ösa nöe’ t
o’swaya’dageha’	o’ swa ya’d a geh a’
o’knöhet	o’ k nöhet
yöjönyanih	yö jönyani h
nigwegöh	ni gwe göh
akhsotgowah	ak hsot gowah
ögwadönih	ögw adöni h
yögweh	yö gweh
oähgwa’	o ähgwa ’
ëwënötgweni’	ë wënö t gweni ’
hëgajëno’kdë’	h ë ga jëno’kd ë’
öknigwenyöh	ökni gwenyö h
o’nöda’	o ’nöd a’
niga’hasdek	ni ga’hasde k
agwenyöh	agw enyö h
aënödeköni’	a ënö de köni ’
deyögwawënyeh	de yögw awënye h
ëyonënöet	ë yo nënöet
dwadö’s	dw adö’s
wa’akninösgo’	wa’ akni nös go’
ha’degagön	ha’ de ga gön
ayakninösgo’	a yakni nös go’
agatga’	a g atga ’
ayaknihodö:’	a yakni hodö :’
ayö’	ayö’
ogwenye’s	ogw enye’ s
ëiyë’he’t	ëi yë’he’ t
hosaonöje:’	hosao nöje :’
gyëdih	g yëdi h
ëgyögo’	ë g yög o’
gëdzöh	g ëdzö h
gashä’	ga shä ’
heyodio’k	he yo dio’ k
wa’öknöhgödë’	wa’ ök nöhgöd ë’
o’gëöh	o’ g ëö h
ëödö:’	ëö dö :’
de’agwayëdeih	de’ agwa yëdei h
tknöge’	t k nöge ’
ësheswashe:’	ë sheswa she :’
o’sahget	o’ s ahget
o’sajä’dak	o’ s ajä’da k
dayaknyatak	d a yakny atak
aeswatganya’t	ae sw at ganya’ t
gyeä’dahgwa’	g ye ä’dahgwa ’
aeskniowi’	ae s kni owi ’
ëgyatga’	ë g yatg a’
aeswashe:’	ae swa she :’
gasenë’shö’öh	ga senë’ shö’öh
deyaknidenyös	de yakni denyö s
eswadënodë’	e sw adënod ë’
wa’esanöe’t	wa’ esa nöe’ t
ie’s	i e’ s
onëhgë’da’	o nëhgë’d a’
aeswageodönyö:’	ae s wage odönyö:’
oya:’jih	o ya:’ jih
gayëtwashö’	ga yëtwa shö’
dëshak	d ë s h a k
o’dzawënye:’	o’ dz awënye :’
daagwisdë’	daa g wisd ë’
skninöe’s	s kni nöe’ s
nö’gat	n ö’ g a t
ojigwë’da’	o jigwë’d a’
odihodö’	odi hod ö’
wa’odinyak	wa’ odi nyak
ëyögwëdë:’	ë yögw ëdë :’
keyëdinonö’	ke yëdino nö’
wahdëje’s	w ahdëje’ s
awënödiatödat	a wënö dia tödat
ësheyësdë’	ë she yësd ë’
hëye’sek	h ë ye’se k
oiwaweso’	o iwa weso ’
gäit	gä it
asënö’geät	a s ënö’geä t
shedës	she dë s
enöe’t	e nöe’ t
shagodinöe’öh	shagodi nöe’ öh
ëyatšonyanö:’	ë y atšon yanö :’
ëgyahsawë’	ë gyahsawë ’
aënënö’geät	a ën ënö’geä t
niwagya’dawës	ni wag ya’d a wës
tšiseksa’ah	tši se ksa’ ah
gayëösdöh	ga yëösdö h
de’sgegëh	de’ s ge gë h
wa’ökni’she:’	wa’ ökni’she:’
yögwayëdak	yögwa yëda k
ni:’	n i :’
honödö’se:’öh	honö dö’se:’ öh
ëöhset	ë ö hset
o’shagodigë’	o’ shagodi gë ’
gëödo’	gë ödo ’
ösakegë’	ösa ke gë ’
gëhgaod	g ëhgaod
o’wahsödadia’t	o’ w ahsöd a dia’t
aknigwas	akni gwas
ayade’go’	a y ade’go ’
o’sadowi’	o’ s adowi ’
ëöwöya’dageha’	ë öwö ya’d a geh a’
ahsadojak	a hs adoja k
öedögwah	öedö gwah
wënënöeta’	wën ënöe ta’
tigagwegöh	ti ga gwe göh
ehnihodö:’	e hn ihodö :’
dëjagohdëja’t	d ë jago hdëj a’t
ga’sehdiyanowe’	ga ’sehd i yanowe ’
o’kyadönyöh	o’ k yadö nyöh
ho’wënishädenyöje’	h o’ w ënishä denyö je’
tösashö’	t ösa shö ’
eshesniowi’	e shesni owi ’
tsa’degahate’dahgöh	tsa’ de ga hate’dah göh
dëgadawënye:’	d ë g adawënye :’
ögwajënönih	ögw ajënöni h
dewawënyes	de w awënye s
waöknöhgödënyo:’	wa ök nöhgödë nyo :’
ha’degaënögeh	ha’ de ga ënö geh
waönidëste’	wa öni dëste’
gyö’öh	gyö’öh
swadënökshö’	sw adë nök shö’
o’gyatgweni’	o’ g yat gweni ’
wa’ökidë:’	wa’ ök idë :’
edwënö’geät	e dw ënö’geä t
onöhsodaiö:’	o nöhsodaiö :’
ëjidwayëto’	ë ji dwa yët o’
ëyeshe:’	ë ye she :’
tiagödaje’	ti agödaje’
ogägwegöh	o gägweg öh
ganöhsesgeka:’	ga nöhs es ge ka:’
niga:’	n i ga :’
aesnyaja’dageh	ae sny aja’d a geh
da’ahsega’ëyö:’	da’ a hse ga’ëyö :’
o’wënënöet	o’ wën ënöet
hojisda’	h o jisd a’
o’kenöe’t	o’ ke nöe’ t
dadiga’eyö:’	d adi ga’eyö :’
ëödiowi’	ë ödi owi ’
waënödënitgädö:’	wa ënö dënitgädö :’
tšisedehjih	tši sedehjih
o’keyëwötas	o’ ke yëwötas
esniya’dageha’	e sni ya’d a geh a’
eswahdëdi’	e sw ahdëdi ’
hoha’shä’	ho ha’ shä’
o’döhgwa’	o ’döhgwa ’
gohigwä:’	go higwä :’
ëyadahset	ë y ada hset
waodiwanägo’	wa od iwa näg o’
honënöedöh	hon ënöed öh
dayeyagë’t	da ye yagë’ t
oga’	o ga ’
ëhsesnye’šö:’	ë hs esnye’ šö :’
ëyögwagweni’	ë yögw agweni ’
ënödowäs	ënö dowä s
ëyodadë:’	ë yo dadë :’
etinö’ëshö’öh	eti nö’ë shö’öh
o’wënödzët	o’ w ënödzët
ësknidë:’	ë skn idë :’
ageowi’	age owi ’
o’wadigo’	o’ w adigo ’
dawënöwënye:’	d a wënö wënye :’
wadöta’	w adöt a’
oihät	o ihät
hösayeyö’	h ösa ye yö ’
sagënöhdönyö:’	sag ënöhdö nyö :’
o’swanöe’t	o’ swa nöe’ t
ayonödi’	a yonö di ’
datak	d atak
askninöe’t	a skni nöe’ t
ahsadowi’	a hs adowi ’
naöëdzo’dë’	na öëdz o’dë ’
yashe’s	ya she’ s
sade’sgoh	s ade’sgo h
dašnye’t	d a šnye’ t
waënödah	wa ënö da h
sgatgwegöh	s g atgweg öh
o’tšadä’negë:’	o’ tš adä’negë :’
niyegëhjih	ni ye gëhjih
sgeowih	sge owi h
tëne’s	t ën e’ s
ëtgahsawë’	ë t g ahsawë ’
ata’dö:’	a ta’dö :’
ëöwödishe:’	ë öwödi she :’
eshesniya’dageha’	e shesni ya’d a geh a’
aesnyadeyës	ae sny ade yës
aegë’	a e gë ’
ayöknigweni’	a yökni gweni ’
heshe’s	he she’ s
edwadawë’	e dw adawë ’
eënöet	e ë nöet
dasayogëhödi’	da sa yo gëhödi ’
yesanöe’s	yesa nöe’ s
wa’odiowi’	wa’ odi owi ’
hadieta’	hadi et a’
wadihšöni’	w adi hšöni ’
jagotga’wëh	jago tga ’wëh
hehsegë’	hehse gë ’
ëhsadeyëös	ë hs adeyëös
ëökyowi’	ë öky owi ’
wa’akniya’dageha’	wa’ akni ya’d a geh a’
dënödih	d ënödi h
eswatgëh	e sw atgë h
wa’kniyö’	wa’ kni yö ’
heyogödahgöh	he yog ödahg öh
tiyöëdzagwegöh	ti y öëdza gweg öh
ayaknyades’a:’	a yakny ades’a:’
wa’ögwadëste’	wa’ ögw adëst e’
dasnye’t	d asnye’t
o’tagöhsa:’hä:’t	o’ tagö hsa:’hä:’ t
honidës	hon idës
niyögidësgwa’	ni yög idës gwa’
ësgeshe:’	ë sge she :’
dawënöhsëto’	dawënöhsëto’
ga’sehdagöh	ga ’sehda göh
kdake’s	k dake’ s
aknënö’geäta’	akn ënö’geä ta’
agegweni’	age gweni ’
gonyos	go nyo s
o’gyeä’dak	o’ g yeä’dak
ayaknyata’dö:’	a yakny ata’dö :’
honödawëh	honö dawë h
eskninöe’t	e skni nöe’ t
agatak	a g atak
ëgyöwötas	ë g y öwötas
gi’shëh	gi’shëh
ëhsnye’šö:’	ë hsnye’ šö :’
hojohdëjöh	ho johdëj öh
ëdwahodö:’	ë dwa hodö :’
onegawänöe’	o nega wänöe ’
ëswahsawë’	ë sw ahsawë ’
ëhnihodö:’	ë hni hodö :’
oyahje’	o yahje’
ašas	a š as
waëh	waëh
wa’ökyonyanö:’	wa’ öky onyanö :’
dagajo:’dat	da g ajo:’dat
dëgyawënye:’	d ë gy awënye :’
waiwayë’	w a iwa yë’
sgadogweta’	s g adogweta’
niënö’s’uh	ni ënö’s ’uh
shöh	shöh
hadikönih	hadi köni h
geshewagö’s	ge shewa gö’s
eswadeköni’	e sw ade köni ’
ëhasdiwatödëh	ë ha sdiwatöd ëh
dayagwayaya’k	da yagwa yaya’k
yödaödö:’	yö da ödö :’
ësgögë’	ë s gö gë ’
gaksa’ah	ga ksa’ ah
agahšönih	aga hšöni h
o’gyadaödö:’	o’ gy ada ödö :’
ha’degagöh	ha’degagöh
jagwenöge’	j agwe nöge ’
hegade’	he ga de ’
ëjakniyö’	ë j akni yö ’
gwanöe’s	gwa nöe’s
ëdwaiwaies	ë dwa iwai es
netihsot	ne ti hsot
o’tanö’skoda’t	o’ ta nö’skoda’ t
deshonödawënyeh	de s honö dawënye h
gëhödaje’	g ëhöda je’
ëwöswëök	ë wö swëök
ögyësdanih	ög yësd anih
ëhsatgëh	ë hs atgë h
o’dwanë’nyaë’	o’ d wa në’nya ë’
akedë:’	a ke dë :’
wadinöe’t	w adi nöe’ t
niyogä:’	ni yog ä :’
snyahseta’	sny ahset a’
ha’dëö	ha’dëö
gadögweta’	g adögwe ta’
göhiyohkoh	gö hiyohko h
hënödowis	hënö dowi s
ögwanösgwayë’	ögwa nösgwa yë’
gyatgëös	gy atgëö s
ëswödi’no’t	ë s wö di’no’ t
ashesniowi’	a shesni owi’
yadiatödas	y adiatöd as
da’aknöe’ö:’	da’aknöe’ö:’
shegëh	s he gë h
aesheswëdë:’	ae sheswë dë :’
honöde’nöhdahöh	honö de’ nöhdah öh
o’keya’dihsak	o’ ke ya’d ihsa k
shehninöe’öh	shehni nöe’ öh
öknënö’gädöh	ök nënö’gäd öh
ëkyatšonyanö:’	ë ky atšony anö :’
hota:’	ho ta :’
ayaknyajeä’t	a yakny ajeä’t
ëkawi’	ë k awi ’
ëgënöhdönyö:’	ë g ënöhdö nyö :’
ëyawëödë’	ë y awëöd ë’
agadeyësdöh	ag adeyësd öh
ëwënötganya’t	ë wënö tganya’t
ëwödiöni’	ë wö diöni ’
niyoisda:’eh	ni yo isda:’ eh
gaöda’	ga öda ’
o’satgato’	o’ s atgat o’
gahsi’da’geh	ga hsi’d a’ geh
yehsënowanëh	ye hsëno wanëh
de’iwayëdeih	de’ iwa yëdei h
ësnyahsawë’	ë sny ahsawë ’
hëšatgödak	h ë š atgödak
sögashä’t	s ögashä’t
aö’esat	a ö’esa t
hegähgwë’sgwah	he gä hgwë’s gwah
o’gadeyës	o’ g adeyës
de’ogee’	de’ o gee ’
ëkniya’dageha’	ë kni ya’d a geh a’
ëgadiatödat	ë g adiatödat
oiwa’shö’öh	o iwa ’ shö’öh
wadiyë’he’t	w adi yë’he’ t
hëyowënöwisat	h ë yo wënöwisat
hodi’nigöë’geh	hodi ’nigöë’ geh
hadahseta’	h ada hset a’
ëötganya’t	ë ö tganya’t
ëhsaja’dageha’	ë hs aja’d a geh a’
oji’gä’	o ji’gä ’
dwadowis	dw adowi s
tsa’dwat	tsa’ d w at
ëdwanöe’t	ë dwa nöe’ t
gaëhdo’yaka:’	ga ëhdo’ya ka:’
agiwa’	ag iwa ’
agadiwadenyö’	ag ad iwa denyö ’
ashakniya’dageha’	a shakni ya’d a geh a’
deodöëdzonih	de o döëdzoni h
nisnyajeha’	ni sny aje ha’
de’agoyëhe’ö:’	de’ ago yëhe’ ö :’
saiwayë’	sa iway ë’
o’dwajës	o’ d wajës
ëöšëya’döh	ë öš ëya’dö h
ënikwais	ë ni kwais
ginöe’s	gi nöe’s
ëgyadënodë’	ë gy adënod ë’
niyaknyajeha’	ni yakny aje ha’
nödowa’ga:’	nödowa’ ga:’
gaënödëh	ga ënödë h
ëyadawë’	ë y adawë ’
tganöhsesgeh	t ga nöhs es geh
degadenyös	de ga denyös
ögwadeyës	ögw adeyës
o’wënödes’a:’	o’ wënö des’a :’
niyonishe’t	ni yonis he’t
gwisagöh	g wisag öh
aedi’gwah	ae di’gwah
nigaies	ni ga ies
gayadoshä’geh	ga yado shä’ geh
aeshesniya’dageha’	ae shesni ya’d a geh a’
heyogë’t	he yo gë’t
odigwenyöh	odi gweny öh
agwaksa’shö’öh	agwa ksa’ shö’öh
dahsahsëto’	d ahsahsët o’
ëhsatšowi’	ëh s atšowi ’
da’agida’öh	da’ ag ida’ öh
wa:’hödë’	w a:’höd ë’
ëswënöhdö:’	ë sw ënöhdö :’
nö’öje’	nö ’ ö je ’
daiowanën	da iowa nën
ganöhsot	ga nöhsot
hadidake’	hadi dake ’
ëyöknigweni’	ë yökni gweni ’
wösatahas	w ösa tahas
niwagöëdzo’dë’	ni wag öëdzo’ dë’
dewagya’dis	de wag ya’d is
wadödë’	w adöd ë’
ëdwatganya’t	ë dwa tganya’t
onëganos	o nëga nos
o’tgawënye:’	o’ t g awënye :’
ëyöknigeodönyö:’	ë yökni geod önyö :’
yehodö:’	ye hodö :’
ëhsata’dö:’	ë hs ata’dö :’
ëyagwayëda’k	ë yagwa yë da’k
ga’nigöiyoh	ga ’nigö iyo h
aesnyadi’	ae sny adi ’
gëöyagëshä’	g ëöyagë shä’
esnyadajenö’	e sny adajenö ’
ësnö’dzodë’	ë s nö’dzod ë’
dadisnye’t	d adi snye’ t
esi’	e s i ’
hëyë’	h ë y ë ’
nësnyaje:’	n ë sny aje :’
hënöhdö’	h ënöhdö ’
hese’sgwa’	he s e’s gwa’
o’gayë’he’t	o’ ga yë’he’ t
agasgatgwëh	aga sgatgwë h
wa’eiwanöe’t	wa’ e iwa nöe’ t
yeyëönö’	ye yëö nö’
hadiyasho’	hadi yas ho’
hodiwiyösdöh	hodiwi yösdö h
gega:’geh	ge ga:’ geh
tënënö’gähdöh	tënë nö’gähd öh
o’jagwë’nyaë’	o’ j agwë ’nya ë’
o’knegeä’	o’ k nege ä’
deyagohda:’	de yago hda :’
hejöhe’t	he j öhe’ t
yeyëdinö’	ye yëdi nö’
ëtonöhdös	ë ton öhdö s
ëhninösgo’	ë hni nösg o’
agadowi’	a g adowi ’
snyatganyeh	sny atganye h
de’oeo’dawëhde’	de’ o eo’dawëhd e’
waëdë:’	wa ë dë :’
sgënöhdönyöh	s gënöhd önyö h
hagöstwi’es	ha gö stwi’ es
ëyesaya’dageha’	ë yesa ya’d a geh a’
aonödi’	a onö di ’
ieh	i eh
yëdës	yë dë s
ëiögo’	ë iö g o’
sgwagëh	s gwa gë h
heyënöhdönyöh	he y ënöhdö nyö h
tëne:’	t ën e :’
ayöknigë’	a yökni gë ’
sanöhsot	sa nöhsot
ëyöjeä’t	ë yö je ä’t
ëwöjowi’	ë w ö jowi ’
ëyagwaninönö’	ë yagwa ninö nö’
wadigeö’	w adi ge ö ’
niyagawënishägeh	ni yagawë nishä geh
dayeyö’	da ye yö ’
ëwöknökdë’	ë wök nökd ë’
ëyögwadashähgwaniak	ë yögw adashähgwani ak
watganye:’	w atganye :’
dada’t	d a da’ t
ëyötak	ë yö tak
ahsehšöni’	a hs ehšöni ’
dayešnye’t	da ye šnye’ t
waëtgë’	wa ëtgë ’
sënöhdö’	s ënöhdö ’
ögahdö:’	öga hdö :’
o’dwënödawënye:’	o’ d wënö dawënye :’
nësaje:’	n ës aje :’
ahset	a hset
wajë:’	w ajë :’
ësnyadi’	ë snya di ’
sënönih	s ënöni h
o’gadö:’	o’ g adö :’
dëdwat	dë dw at
dasta’	dasta’
gyadaödö:’	gy ada ödö :’
ögwaënö’	ögwa ënö ’
dëyawënye:’	d ë y awënye :’
ëhsadadatgaëö’	ë hs adad atgaëö’
nëtgade’	n ë t ga de’
heyonöja’göh	he yonö ja’gö h
aesni’	ae sni ’
dawagënöhdök	d a wag ënöhdö k
niyugu’uh	ni yug u’uh
shonöhdëjöh	s honö hdëj öh
eënö’geät	e ënö’geät
o’jagwadögot	o’ j agw adögot
agwayë’he’öje’	agwa yë’he’ ö je’
tiyöëdzagwegöh	ti y öëdza gwegöh
o’ta’wastaah	o’ t a’wastaa h
hodiwisdayë’	hodi wisd a yë’
ëgahšöniak	ë ga hšöni ak
yayë’	ya yë ’
aye’	aye’
edwatgëh	e dw atgë h
ëkedë:’	ë ke dë :’
odigeodönyöh	odi geod önyö h
tonötganyeh	t onö tganye h
onödowa’geonö’	o nödowa’ ge onö’
ëdwayë’he’t	ë dwa yë’he’ t
aehnishe:’	ae hni she :’
hodigëh	hodi gë h
hekne’sgwa’	he kne’s gwa’
akninöe’s	a kni nöe’ s
ëgayeä’dak	ë ga yeä’d ak
o’gyënëda’t	o’ g yënëda’ t
ëskyowi’	ë sky owi ’
o’gaya’k	o’ ga ya’k
agešnye’t	agešnye’t
ëwötšëödase’	ë w ö tšëödase ’
hakea’	h a ke a ’
deyadahnönyöh	de y adahn önyö h
awadiköni’	a wadi köni ’
shesninöe’öh	shesni nöe’ öh
eswaya’dageha’	e swa ya’d a geh a’
o’dwatak	o’ d w atak
ohiyo’gwah	o hiyo’ gwah
shonödadëöh	s honö dadëö h
ëwödiyagë’t	ë wödi yagë’ t
niyagwadih	ni yagw adi h
sayödewadë’	sa yö dewad ë’
waihšöni’	wa i hšöni ’
dwaya’s	dwa ya’ s
niyagwajehak	ni yagw aje ha k
hage’sek	h a ge’s ek
sheyatgatoh	she yatgato h
gaiwayëdak	ga iwa yë dak
swagyöh	s wag yö h
hadigëhjishö’öh	hadi gëhji shö’öh
towödihsadö’	t owödi hsadö ’
ga’šodä:’	ga ’šodä :’
agyadekönyanö’	agy adeköny anö ’
hejagoyagë’öh	he jago yagë’ öh
wa’aknyatgëh	wa’ akny atgë h
ëöhšöni’	ë ö hšöni ’
o’shagodiyö’	o’ shagodi yö ’
hodiwiyosdöh	hodi wiyosdö h
wënödes’a:’	wënö des’a :’
ësaowi’	ësa owi ’
ha’dadiya’diha’	ha’ d adi ya’di ha’
o’shaknidë:’	o’ shakn idë :’
sajöh	s ajö h
godiwadenyö’	go d iwa denyö ’
taknigöëyënih	t ak nigöëyëni h
nëh	nëh
niyoisda’ek	ni yo isd a’ ek
dëswatak	d ë sw atak
wagweni’	w a gweni ’
howöde’	howö de ’
wa’ökiyo’	wa’ öki yo ’
ëhša’dageha’	ë hš a’d a geh a’
wadijën	w adi jë n
johsa’	j ohsa ’
wagya’dageha’	w ag ya’d a geh a’
dawadawënye:’	d a w ada wënye :’
ayodigweni’	a yodi gweni ’
ayaknya’hödë’	a yakny a’höd ë’
snyatgëöh	sny atgëö h
ëgäje’	ë g äje ’
ho’ge:’	h o ’g e :’
ëgades’a:’	ë g ades’a :’
ësniyödago’	ë sni yöda go’
da’daosaya’dagehëh	da’ dao sa ya’d a geh ëh
agaja’dagehas	ag aja’d a geh as
dwadeyësta’	dw ade yës ta’
ëswageodönyö	ë sw ageodö nyö
gyadënota’	gy adëno ta’
gotganya’döh	go tganya’ döh
sheya’dagehëh	she ya’d a geh ëh
o’gatsën	o’ g atsën
ëhnënöet	ë hn ënöe t
owgenyöh	owge nyöh
heta’	h e ta’
wa’aknyadaöhdiyos	wa’ akny adaöhdiyos
ëhsadojak	ë hs adojak
satahgwëh	s atah gwëh
aksot	ak sot
agöhö’t	ag öhö’ t
ëhsadögwe’	ë hs adögwe’
ehnishe:’	e hni she :’
öknyaje’s	ökny aje’s
ëkekwanön	ë ke kw a nön
wa’aknyadeyës	wa’ akny ade yës
shögwanögödenyeh	shögwa nögöd enye h
aknigöë’geh	ak nigöë’ geh
wögö’	w ög ö ’
hawe:’	ha we :’
wënöjënönih	w ënö jënöni h
do’onëhjih	do’ onëh jih
wadëdoek	w adëdoe k
o’ša’k	o’ š a’ k
onö’gägo’	o nö’gägo ’
ënöjowi’	ënö jowi ’
hegähgwë’s	he gä hgwë’ s
keiwadëhdanih	ke iwa dëh dani h
ëöwodiowi’	ë öwodi owi ’
niyoiwa’	ni yo iwa ’
ëshënöjo’data’	ë s hënö jo’d a ta’
ahsadeyës	a hs adeyës
ayetšidë:’	a yetš idë :’
ëgadënö’geät	ë g adënö’geät
aedwayeä’dak	ae dwa yeä’da k
dëgwanönyö:’	d ë gwa nö nyö :’
hegegwas	he ge gwas
hona’gaiwanës	ho na’ga iwanë s
dëgawënye:’	d ë ga wënye :’
o’satgëh	o’ s atgë h
ësedzagö:’	ë se dzagö :’
o’gajo:’dahsi’	o’ g ajo:’da hsi’
da’dewagadëdzonih	da’ de w agadëdzoni h
dewahsö	de w ahsö
deswayenö’	d eswa yenö ’
ösödagöh	ösö dagö h
haiwayëöh	ha iwa yëö h
hëgae’	h ë ga e ’
ahsatga’	a hs atg a’
tota’	t o ta ’
hëöweh	hëöweh
dagya’dagë’t	d a g ya’d a gë’ t
wadiköni’	w adi köni ’
hëdës	hë dë s
aodidogës	a odi dogës
o’gyadawë’	o’ gy adawë ’
ëhnyatganya’t	ë hny atganya’ t
ögwe’öweneh	ögw e’öwe neh
o’kedë:’	o’ ke dë :’
henöe’öh	he nöe’ö h
agyatgëh	agy atgë h
aeswajeä’t	ae sw ajeä’ t
ëhsnösgo’	ë hs nös go’
o’wadiwahdëdi’	o’w ad iwa hdëdi ’
ëwödeköni’	ë wö de köni ’
niyönishe’t	ni yö nishe’ t
ahsajeä’t	a hs ajeä’ t
sayögwa’se:’	sa yögwa ’se :’
hahsaha’	ha hsah a’
sadeyësdöh	s ade yës dö h
wa’ögwëdëste’	wa’ ögw ëdë ste’
snyadaödö:’	sny ada ödö :’
ga’se	ga ’se
onënöetöh	o nënöetö h
haya’dagehas	ha ya’d a geh as
shenöe’öh	she nöe’ö h
sayagwayö’	sa yagwa yö ’
da’agyëda’k	da’ agy ëda’k
ashesnigë’	a shes nigë ’
watak	w atak
högak	högak
o’disnideni’	o’ di sni deni ’
ëyagwatgëö’	ë yagw atgëö ’
sënöhdönyöh	s ënöhdö nyö h
ehniögo’	e hni ögo ’
swakönih	sw aköni h
asknigë’	a skni gë ’
ha’dewahsënöh	ha’ de w ahsënö h
aeswaja’dageh	ae sw aja’d a geh
ëwötwadase’	ë wö twadase’
ganöhsön	ga nöhs ön
gwas	gwas
ëyadaödö:’	ë y ada ödö :’
aeswade’go’	ae sw ade’ go’
hadisae’ja’s	hadi sae’ja’ s
deyosohgwageh	de yo sohgwage h
ajeä’t	ajeä’ t
yökdös	yö kdö s
eya’dageha’	e ya’d a geh a’
aidë:’	a idë :’
gyatganyeh	gy at ganye h
wadake’	w adake’
deyodawënyeh	de yo dawënye h
agiode’	agi ode ’
onegase:’	o neg a se:’
osgë’sä’	o sgë’sä ’
hegajisdayë’	he ga jisd a yë’
o’ge’	o’ g e ’
sahsot	sa hsot
osheä’	o sheä ’
deh	deh
akniowih	akni owi h
ëdwasgawagë’t	ë dwa sgawagë’ t
deatahgwa’	de atahg wa’
niyagoyë’hë’ök	ni yago yë’ hë’ ö k
agataë’	ag ata ë ’
ëdwayä’dak	ëdwa yä’d a k
ëyodiowi’	ë yodi owi ’
nihšönih	ni hš öni h
ënötšonyanö:’	ënö tšony anö :’
niyohsoh	ni yo hso h
gaheneh	ga hene h
deyeyëhö:’	de ye yëhö :’
ëswaga’ëyö:’	ëswa ga’ëyö :’
swaya’dawës	swa ya’d a wë s
adi’gwah	adi’gwah
ëhse’sek	ë hs e’s ek
ögawih	öga wi h
aeyetiowi’	ae yeti owi ’
osgwai’da’	o sgwai’da ’
tah	tah
adigë’	adi gë ’
wa’eya’dageha’	wa’ e ya’d a geh a’
öknyaja’dagehas	ökny aja’d a geh as
ögwadä’swiyoh	ögwa dä’s wiyo h
gëhga:’	gë hga :’
ësknigë’	ë skni gë ’
gwas’öweh	gwas’öweh
ëdzödatewat	ë dzö datewat
ënöhdëdi’	ënö hdëdi ’
so’t	so’t
de’swadënök	de’ sw adë nök
sniyë’he’öh	sni yë’ he’ ö h
ayodekak	a yo deka k
adaödö:’	ada ödö :’
aedwahdëdi’	ae dw ahdëdi ’
dakniya’dowet	d a kni ya’dowet
wonökdë’	wo nökdë ’
niyoh	niyoh
hagëhjih	ha gëhji h
aeowi’	ae owi ’
sheawakshö’	she awak shö’
ho’gaeyeät	ho’ ga eyeät
agwasöyö’	agwa söyö ’
deyagwa’nya:’	de yagwa ’nya :’
tionöjeëh	ti o nöjeë h
ëhsahdoh	ë hs ahdo h
shodönih	s ho döni h
agegë’	a ge gë’
nagayëök	na ga yëö k
deadenyös	de adenyös
ähdahgöh	ähdahgö h
esniögo’	e sni ögo’
nodiya’dawëh	n odi ya’d a wë h
ëhsehšöni’	ë hse hšöni ’
wayajëgwah	wa y ajëgwah
hodawëh	ho dawë h
dayökisnyek	da yöki snye k
is’ah	is’ah
gano’gä:’	ga no’gä:’
wadigëhjishö’öh	wadi gëhji shö’öh
ëyaknihodö:’	ë yakni hodö :’
ëyagwaganya’k	ë yagwa ganya’ k
ga’nö’	ga ’nö’
ëdwayëtwahshö’	ë dwa yë twah shö’
gadi’gwah	gadi’gwah
jëih	jëih
ëwötganye:’	ë wö t ganye :’
ëseganya’k	ë se ganya’ k
da’ayo’dëök	da’ a yo’dë ök
ayakniyeä’dak	a yakni yeä’da k
yeya’däje’s	ye ya’dä je’ s
ögida’	ög ida’
o’watganya’t	o’ w at ganya’ t
dëöwödinönyök	d ë öwödi nönyö k
eswajeä’t	e sw ajeä’ t
waöwödiya’dagëyadë’	wa öwödi ya’d a gë yadë’
todinösgwayëda’s	t odi nösgwa yëda’s
waodë:’	wa o dë :’
haya’da:’	ha ya’da :’
hnyatganya’ta’	hny at ganya’ ta’
ögwayëtwëh	ögwa yë twë h
dënöhsëto’	d ënö hsët o’
netgadeh	n e t ga de h
da’deta’nigöëyei’	da’ de ta ’nigöë yei ’
swadö’s	sw adö’ s
ogwa’	ogwa’
dëhsek	d ë hs e k
ëinösgo’	ë inös go’
ësninöe’t	ë sni nöe’ t
ohsohgwa’	o hsohgwa ’
hëswe’sek	h ë sw e’s e k
negë’weëh	ne g ë’weë h
öknyadehsa’öh	ökny adehsa’ öh
o’sniya’dageha’	o’ sni ya’d a geh a’
hëswayö’	h ë swa yö ’
wa’öjo’data’	wa’ ö jo’dat a’
ökiyësdanih	öki yës dani h
ëshaknidë:’	ë shakni dë :’
ëhsajënöni’	ë hs ajënöni ’
o’we:’	o’ w e :’
o’wadiatödat	o’ w adiatödat
awënö’hödë’	a wënö ’hö dë’
saënödiwahšoni’	saënödiwahšoni’
ënö’hödë’	ënö ’hö dë’
ëwödihodö:’	ë wöd ihodö :’
dësnyadawënye:’	dë sny ada wënye :’
aeshehnigë’	ae shehni gë ’
ëyagogë’	ë yago gë ’
yödowis	yö dowi s
ëyagoyëto’	ë yago yëto ’
ëswadeyës	ë sw ade yës
heowih	he owi h
swatgatwëh	sw atga twëh
de’gëh	de’ g ë h
gahänöge’	ga hänöge ’
oneganos	o nega no s
waonënöeta’	waonë nöet a’
gwayënëda’t	gwa yënëda’ t
ögwahodö’	ögwa hodö ’
deyedenyös	de ye denyös
nigaëno’dë’s	ni gaën o’dë ’s
ëhsadeköni’	ë hs adeköni ’
döwöshanis	d öwö shani s
aganösgo’	a ga nös go’
osgatgwa’t	o sgatgwa’t
yöhseta’	yö hse ta’
nijodagöh	ni jodagö h
ëödiyënëda’t	ë ödi yënëda’ t
ëyagwak	ë yagwa k
wa’otgato’	wa’ o t ga to’
ëyeadö:’	ë ye adö :’
ësnyahdëdi’	ë sny ahdëdi’
wahegë’	wahe gë ’
hösayö’	hösa yö ’
aeswagë’	ae swa gë ’
ëne’sek	ë n e’s e k
dayë’	da yë ’
hadowis	h adowi s
gyä:’ta’	gy ä:’ ta’
gahodögwa’shä’	ga hodögwa’ shä’
hadinähgwis	hadi nähgwi s
aknigë’	akni gë ’
agagweni’	a ga gweni ’
išnye’s	i šnye’s
ëwötgweni’	ë wö t gweni ’
naeswaje:’	nae sw aje :’
jigwashöh	jigwashöh
ashagodiya’dageha’	a shagodi ya’d a geh a’
niayëno’dëh	ni a yën o’dë h
ogo’dza’	ogo’dza’
ëyedzëö’	ë ye dzëö ’
o’töwödi’oäk	o’t öwöd i’oä k
eswajoek	esw ajoe k
nëödiye:’	n ë ödi ye :’
niyoshedëh	ni yo shedë h
snyadawëh	sny adawë h
waënöhget	wa ënö hget
keshe’s	ke she’ s
ëwënö’hödë’	ë wënö ’hö dë’
ganöhses	ga nöhs es
hase’sek	h a s e’s ek
o’gata’dö:’	o’ g ata’dö :’
sgidës	sg idë s
shökniya’dagehas	shökni ya’d a geh as
ëyökigë’	ë yöki gë ’
nëge:’	n ë g e :’
ojanön	o janö n
jöëdzade’	j öëdza de’
haksa’gowah	ha ksa’ gowah
nidwayeha’	ni dwa ye ha’
hatganya’ta’	h at ganya’ ta’
wa’ökigwat	wa’ öki gwat
ëshakniowi’	ë shakni owi ’
wa’aknyatgweni’	wa’ akny at gweni ’
hënödaöhgwa’	hënö daöhgwa’
waöwöya’dageha’	wa öwö ya’d a geh a’
ëhseadö:’	ë hse adö :’
ëyänötgëni’	ë yä nötgëni ’
hönötöde’	hönö töde ’
wadi’hasdëh	wadi ’hasdë h
swadeyëstöje’	sw ade yë stö je’
niënö’s’ah	ni ënö’s’ ah
eskniya’dageha’	e skni ya’d a geh a’
aga’hödë’	aga ’hö dë’
ëyöknënöeta’	ë yökn ënöet a’
weëh	weëh
ëdwajeën	ë dw ajeë n
gonöhdö’	go nöhdö ’
dwahseta’	dwa hse ta’
waodi’se:’	wa odi ’se :’
nisgawëno’dëh	ni s ga wën o’dë h
o’tënödeni’	o’t ënö deni’
ökiyashähgwanih	öki yashähgw anih
oänöwëh	o änöwë h
tösagajo:’data’	tösa g ajo:’dat a’
ögwaiwihsa’öh	ögwa iwi hsa’ öh
de’swaiwayëdeih	de’ swa iwa yëdei h
ëgatganya’t	ë g at ganya’ t
aedwanöe’t	ae dwa nöe’ t
aënöet	a ënöet
ëshögwaowi’	ë shögwa owi ’
ëwënödowi’	ë wënö dowi ’
nigaya’do’dëh	ni ga ya’d o’dë h
waönënöje’	wa önënö je ’
dawatak	da w atak
deniyasheh	de ni yasheh
do’ogwënöhdö’	do’ ogw ënöhdö ’
aesnihodö:’	ae sni hodö :’
ayötga’	a yö tga’
dewënödënöde:’	de wënö dënöde :’
gajihsa’	ga jihs a’
gëögwas	gë ögwas
wadöišök	w adöišök
yö’höta’	yö ’hö ta’
gaswëhda’	ga swëhd a’
aishe:’	ai she :’
dagö’	d a gö ’
wa’osdëöjehsö:’	wa’ o sdëöjehsö :’
wa’öhdëdi’	wa’ ö hdëdi’
osnö’	o snö ’
hösanöe’öh	hösa nöe’ öh
onökdëh	o nökdë h
dwajënönih	dw ajënöni h
sageodönyöh	sa geodö nyö h
wa’ögwaowi’	wa ’ö gwaowi ’
asnishe:’	a sni she :’
yejëönyanih	ye jëöny ani h
aknyahseta’	a kny ahse ta’
ëyosdëödi’	ë yo sdëödi’
wa’oyahje’	wa’ o yah je’
o’sadënodë’	o’ s ad ëno dë’
ayagogweni’	a yago gweni ’
daeswahsëto’	d ae sw ahsët o’
etino’ëh	eti no’ëh
söde’	söde’
hehsegëh	he hse gë h
o’hasdaje’	o ’hasd a je’
ahsatgweni’	a hs at gweni ’
dwënö’geäta’	d w ënö’geät a’
aesniköni’	ae sni köni ’
gaë’	ga ë ’
awahset	a w ahset
waöwaowi’	waöwa owi ’
dëte’	d ë t e ’
wayënëda’t	wa yënëda’ t
nioshiya’göh	ni o shiya’ göh
eswade’go’	e sw ade’ go’
ëwögegë’	ë wöge gë ’
ha’deyogäëh	ha’ de yo gäë h
adojak	a dojak
gwenyöh	gwe nyöh
wa’öhsawë’	wa’ ö hsa wë’
nigaëno’dëh	ni ga ën o’dë h
ëhsades’a:’	ë hs ades’ a:’
de’oyëdet	de’ o yëdet
o’nigöë’	o’nigöë ’
ëösgatgwëh	ëö sgatgwë h
gyögwas	gy ögwas
niyawëh	ni ya wë h
dewënishägeh	de w ëni shä geh
ayaknidë:’	a yakn idë :’
o’ke’daswaëh	o’ ke ’da swa ë h
kewakshö’	ke wak shö’
waënëdöishë:’	wa ënë döi shë :’
dëöwödišnyeh	dë öwödi šnye h
agwahdöh	agw ahdö h
tayögwayëdak	ta yögwa yë dak
wënitšiyoh	w ëni tšiyoh
ha’degya’dih	ha’ de g ya’d ih
de’osde’	de’ o sde ’
edwajo’dahsi’	e dw ajo’d a hsi’
heyagwë’jödak	he yagw ë’jödak
eswëögo’	e swë ögo’
wadigwenye’s	w adi gwenye’ s
wasödagwegöh	w asöd a gwegöh
wa’akniyë’he’t	wa’ akni yë’ he’ t
yakgeöhëd	yakgeöhëd?
shögwagëh	shögwa gë h
wa’aknyahget	wa’ akny ahget
gyadahseta’	gy ada hse ta’
agwë’	agw ë ’
da’ögwatödëh	da’ ögw atödë h
shesniya’dagehëh	shesni ya’d a geh ëh
de’	de’
tade’	t a de ’
hegi’jö’	he g i’jö ’
dekniyasheh	de kni yashe h
ëdashësnye:’	ëda shë snye :’
onödza’	o nödz a’
ëgiwa’hödë’	ë g iwa ’hö dë’
waënödöišök	wa ënö döišök
agegë’	a ge gë ’
otsinöhgë’da’	o tsinöhgë’d a’
o’wajesa’ge’he’t	o’ w ajesa’ge’ he’ t
ëyökinöe’t	ë yöki nöe’ t
todinökdanineh	t odi nökdanineh
o’gyajowi’	o’ gy ajowi ’
daoiwadiyötas	da o iwa diyötas
ëgyadojak	ë gy adojak
agatši’waë’	a g atši’wa ë ’
ahsadadeha’t	a hs adadeha’t
höweh	h öwe h
hëöknö’kwë’öh	h ëök nö’kwë’ öh
o’sgeowi’	o’ sge owi ’
ëyödahset	ë yö dahse t
iat	i a t
ëknihšöni’	ë kni hšöni ’
awë’öjeh	awë’öjeh
o’ënöhdönyö:’	o’ënöhdö nyö :’
etinöe’öh	eti nöe’öh
goshe’s	go she’ s
aiyë’he’t	a i yë’ he’ t
dëswanöönyö:’	d ë swa nöö nyö :’
esnigo’	e sni go ’
hoio’daje’s	ho io’da je’s
gidöh	g idö h
yese’s	y ese’s
ödaë’ska:’	ödaë’ska:’
wadë’gwäyë:’	w adë’gwä yë:’
ganöhgwa’tšiyoh	ga nöhgwa’ tš iyo h
dedwadawënyeh	de dw ada wënye h
aedwagweni’	ae dwa gweni ’
o’keya’dat	o’ ke ya’da t
ëhnënöhdönyö:’	ë hn ënöhdö nyö :’
o’tadiwaë’	o’t ad iwa ë ’
dayakninöönyö:’	d a yakni nöö nyö :’
o’tadeyëöhs	o’ t ade yëö s
dejojëhdöh	de j o jëhdö h
swa’höta’	swa ’hö ta’
o’wade’go’	o’ w ade ’go’
ësgwëdë:’	ë sgwë dë :’
ögadiwajeö’	ög ad iwa jeö’
aehniyë’he’t	ae hni yë’ he’ t
ësageodönyö’	ë sageodö nyö’
hadiyasta’	hadi yas ta’
hodikwa’	hodi kwa ’
wa’aknyatga’	wa’ akny atga’
ëyökiyadowi’	ë yöki y adowi ’
swaowih	swa owi h
gaiwawetahöh	ga iwa wetahöh
ëödiyë’he’t	ëö di yë’ he’ t
ëöya’k	ë ö ya’ k
wiyos	w iyo s
wa’agwaë’he’t	wa’ agwa ë’ he’ t
satganya’ta’	s at ganya’ ta’
dëödisnye’	d ë ödi snye ’
ëösatahas	ëös ataha s
swadawëh	sw adawë h
ëyagwe’sek	ë yagw e’s e k
ögadä’swë’t	ögadä’swë’t
ehnië’	e hni ë ’
yedake’s	ye dake’ s
sagwenyöh	sa gwe nyö h
niyögyajeëh	ni yögy aje ëh
awadaöhdiyos	a w adaöhd iyos
dëdwadeni’	d ë dw adeni ’
jagwanöge’	j agwa nöge ’
edwatganye:’	e dw at ganye :’
shehnigëh	she hni gë h
gawišoa’	ga wišo a’
ëwödigo’	ë w ödi go ’
aodi’nigöëyëda’t	a odi ’nigöë yë da’ t
edwatgweni’	e dw at gweni ’
gäidodö’	gäid o dö’
hehne:’	he hn e :’
agwasöweh	agwa söwe h
ëga’hödë’	ë g a’hö dë’
ëyagogeodönyö’	ë yago geodö nyö’
de’jawë’öh	de’jawë’öh
ha’degoshäeh	ha’ de goshä eh
hëyagwaisak	h ë yagwa isa k
dagegë’	da ge gë ’
o’wadiköni’	o’ w adi köni ’
gono’kwë’öh	go no’kwë’ öh
hënöhdëje’s	hënö hdëje’s
hehne’sgwa’	he hn e’s gwa’
shagodinöe’s	s hagodi nöe’ s
wa’oyë’gwahsöwi’	wa’ o yë’gwahsöwi’
ëswatgweni’	ë sw at gweni ’
hadiyastak	hadi yasta k
ahseadö:’	a hse adö :’
haeswe’sek	h ae sw e’s e k
wa’akniyeä’dak	wa’ akni ye ä’dak
ësnyadzët	ë sny adzët
ëödiya’k	ë ödi ya’ k
tagatgëh	t a g at gë h
deyodetgwëhdëön	de yo detgwëhdëö n
swatganya’döh	sw at ganya’ dö h
o’shögwagë’	o’ shögwa gë ’
ëyökigë’	ë yöki gë ’
gya’dagehas	g ya’d a geh as
ëhsahdëdi’	ë hs ahdëdi’
ëyetiya’dageha’	ë yeti ya’d a geh a’
knidës	kn idë s
haša’däje’t	h a ša’d äje’t
öknyaja’dageh	ökny aja’d a geh
gešnye’s	ge šnye’s
ëswë’	ë sw ë’
nö’saje’	n ö’ s aje ’
ho’gya’däje’t	h o’ g ya’d äje’t
edwadojak	e dw adojak
gyënëda’t	g yënëda’ t
ëgatödë’	ë g atödë ’
ësganenö:’	ë s ga nenö :’
ëgatši’waë’	ë g atši’wa ë ’
hoshani’öh	ho shani’ ö h
deögwënöhdö’	de ögw ënöhdö ’
yeyasöh	ye yas öh
wa’ödö’	wa’ ö dö ’
nödayawëh	nödayawë h
ëyetšishe:’	ë yetši she :’
ëgöganya’gë’	ë gö ganya’ g ë’
o’wënödaöhdiyos	o’ wënö da öhd iyos
ëödiya’dageha’	ë ödi ya’d a geh a’
wa’ënö’geät	wa’ ënö’geät
ohsinö’da’	o hsinö’d a’
onënöete’s	o nënöete’ s
hedwe’sgwa’	he dw e’s gwa’
odiya’göh	odi ya’g öh
hadiatödas	hadi atödas
ganödaseonö’	ga nöd a se onö’
dëhninöönyö:’	dë hni nöö nyö :’
heyotwadaseh	he yo twadase h
hodiyëdö’	hodi yëd ö’
niadö’s	ni adö’ s
waënödetgayas	wa ënö detgaya s
ënöjä:’dak	ënö jä:’da k
deyögwadöëdzonih	de yögwa döëdzoni h
šeä’dahgwa’	šeä’dahgwa’
watgwë:’	w atgwë :’
agënö’geädöh	ag ënö’geäd öh
o’sagweni’	o’ sa gweni ’
dëyadahnoöhgwak	dë y adah noöhgwak
snyadojas	sny adoja s
waya’dageha’	wa ya’d ageh a’
desnyadënöde’	de sny adënöde’
aknyadaöhdiyosta’	akny ada öhd iyo sta’
sekönih	se köni h
daeyö’	d a e yö ’
onähda’	o nähd a’
degönyahsöhs	de gö nyahs öhs
ashögwaya’dageha’	a shögwa ya’d a geh a’
o’sadaödö:’	o’ s ada ödö :’
ëödinö’kwë’	ë ödi nö’kwë’
gatga’gës	gatga’ gës
niaio’dëh	ni a io’dë h
etiya’dagehëh	eti ya’d a geh ëh
sajeä’ta’	s ajeä’t a’
deye’nyä:’	de ye ’nyä :’
ëgajo’dat	ë g ajo’dat
agwadade’gë’shö’	agw adade’ gë ’ shö’
niyënëda’s	ni y ënëda’ s
gya’da:’	g ya’d a :’
niyagwayëdeih	ni yagwa yëdei h
wa’eoö’	w a’eoö ’
niyökiyeha’	ni yöki ye ha’
ëgata’dö:’	ë ga ta’dö :’
akniögo’	akni ögo’
aesnyatgato’	ae sny atga to’
dayetišnye’	da yeti šnye ’
o’disninönyö:’	o’di sni nö nyö :’
aweo’da’	a weo’d a’
ëyagwadi’stäh	ë yagw adi’stä h
ahsahsawë’	a hs ahsawë ’
ga’sehdiyanoweh	ga ’sehdi yanoweh
awatga’	a watga’
ëyeya’dageha’	ë ye ya’d a geh a’
sajä:’dahgöh	s ajä:’d ahgöh
o’wënödiatödat	o’ wënö diatödat
ayakniya’dageha’	a yakni ya’d a geh a’
o’toknönyö:’	o’t ok nö nyö :’
aknöe’s	ak nöe’ s
aigëh	aigëh
hayë’he’s	ha yë’ he’ s
o’dwagya’dis	o’d wag ya’dis
o’jaknideni’	o’j akni deni’
hodinöhsodö’	hodi nöhsod ö’
geksa’ah	ge ksa’ ah
shögwashe’s	shögwa she’ s
hadiya’deönyö’	hadi ya’d eö nyö ’
nëgye:’	n ë g ye :’
esknishe:’	e skni she :’
nigëh	nigëh
waënödeyës	wa ënö de yës
aedwadöishë:’	ae dw adöi shë :’
ha’deyeya’diha’	ha’ de ye ya’diha’
niyögwaiwayëdahgök	ni yögwa iwa yë dahgö k
aehniya’k	ae hni ya’ k
ga’ah	ga’ah
sniyë’he’s	sni yë’ he’ s
ayagwatganya’t	a yagw at ganya’ t
o’sninöe’t	o’ sni nöe’ t
satga’	s atga’
deyonöwënyeh	de yonö wënye h
sagyëto’	sa g yë to’
wajënöni’	w ajënöni ’
o’tsdeni’	o’t s deni ’
knisgatgwë’s	kni sgatgwë’ s
ëwögatëhda:’	ë wög atëhda :’
niswayë’he’öh	ni swa yë’ he’ öh
waajë:’	wa ajë :’
shöknishe’s	shökni she’ s
nëwöje:’	n ë wö je :’
ëwöhji’gät	ë wö hji’gät
aknyahsaha’	akny ahsah a’
wëne’sgwa’	wën e’s gwa’
aesnyadawë’	ae sny adawë ’
dwadaödö:’	dw ada ödö :’
akihsot	aki hsot
dawageswa’dë’	da wage swa ’dë’
ëödinöe’t	ë ödi nöe’ t
ësnyatganye:’	ë sny at ganye :’
goya’dahdö’öh	go ya’dahdö’ öh
o’gajë:’	o’ g ajë :’
oihsa’	o ihs a’
öknyatgatwas	ökny atga twas
ëtshegödak	ë t she gödak
niyoshägeh	ni yo shä geh
wa’ögesgatgwëh	wa’ öge sgatgwë h
o’shedë:’	o’ she dë :’
snisgatgwë’s	sni sgatgwë’ s
waöwödiyenöwö’s	wa öwödi yenöwö’s
ëyaknyadeköni’	ë yakny ade köni ’
ayaknigo’	a yakni go’
awatganya’t	a w at ganya’ t
ënötganye:’	ënö t ganye :’
ajëönyanihshä’	ajëönyanih shä’
aesnyatgëh	ae sny atgë h
akyatšonyanö:’	a ky atšony anö :’
adöwë’	adöwë’
hadiödas	hadi ödas
saja’dawi’t	s aja’dawi’ t
eswayë’he’t	e swa yë’ he’ t
aköni’	a köni ’
o’jagwatak	o’j agw atak
o’gatga’	o’ g atga’
nijojeëh	ni jo je ëh
nödayagwe:’	nöda yagw e :’
hodiwawëh	hodi wawë h
ëösanön	ë ösa nön
nadiye:’	n adi ye :’
ëgahset	ë g ahset
nëwögasha:’t	n ë wög asha:’ t
ëshatadik	ë sha tadi k
da’deyöh	da’ de yö h
gahsaha’	ga hsah a’
o’gasgatgwëh	o’ ga sgatgwë h
o’sënö’geät	o’ s ënö’geät
agega’has	age ga’has
o’gahsawë’	o’ g ahsawë ’
onötgëöh	o nötgëö h
nëgaegë’	n ë ga e gë ’
honöhdëjöh	hon öhdëjö h
ëöhget	ë ö hget
kniya’s	kni ya’s
goya’dayei’öh	go ya’d a yei’ öh
keawakshö’	ke awak shö’
ëyagwatganya’t	ë yagw at ganya’ t
eshe:’	e she :’
jitöwëdöh	ji tö wëdö h
dawë:’	d a w ë :’
ögyadeo’	ögy adeo’
hea’	he a ’
oädöhgeh	o ädöh geh
yenösgwas	ye nös gwas
o’keyowi’	o’ ke y owi’
ëhseshe:’	ë hse she :’
da’ayötgweni’	da’ a yö t gweni ’
göwök	gö wök
snyadënota’	sny adëno ta’
ëgayëdetehšöni’	ë ga yëdetehšöni ’
ëgadinë’	ë g adinë ’
ganöwöyëhdö:’	ga nöwöyëhdö :’
sagaöhedas	sa gaö hed as
ësgya’dageha’	ë sg ya’d a geh a’
wa’ögyet	wa’ ö gyet
disnyahdëjöh	di sny ahdëjöh
hogëh	hogëh
ëödiyeis	ë ödi yei s
desgayëödähgöh	de s ga yëödähgöh
o’wënötšowi’	o’ wënö tšowi ’
ayë’hë’t	a yë ’hë’ t
ëswahdëdi’	ë sw ahdëdi’
o’kniyeä’dak	o’ kni yeä’dak
onenö’	o nen ö’
o’knisgatgwëh	o’ kni sgatgwë h
nayagwaje:’	n a yagw aje :’
yeyada:’	ye yada :’
tšiyagwaksa’shö’öh	tši yagwa ksa’ shö’öh
hënöta’dös	hënö ta’dö s
ëwödöni’	ë wö döni ’
aënöda’sën	aënö da ’sën
woya’datgëh	wo ya’d a tgë h
doja’dëdöh	d o ja’dëdöh
aosga’ah	aosga’ah
ge’döhsä’göh	ge ’döhsä’ göh
hodihšönih	hodi hšöni h
ëyögidë:’	ë yögi dë :’
nisajeëh	ni s aje ëh
wa’ökiyësdë’	wa’ öki yës dë’
o’gënöhdönyo:’	o’ g ënöhdö nyo :’
ayögeowi’	a yöge owi ’
dwahdëje’s	dw ahdëje’s
gogwëh	go gwë h
waögya’dägo’	wa ög ya’d ägo’
ëwënötšonyanö:’	ë wënö tšony anö :’
yeshe’s	ye she’s
ëwödi’no’t	ë w ö di’no’t
wadinösgwas	wadi nö sgwas
o’tënödi’stanega:’	o’t ënö di’sta nega :’
agegwenye’s	age gwenye’ s
ösadoöh	ösadoöh
ayöknyatgato’	a yökny at ga to’
hoënöyë’	ho ënö yë’
ëwödiyë’he’t	ë wödi yë’ he’ t
hakno’sëgëö’	hak no’së gëö’
hodiyë’he’öje’	hod iyë’ he’ ö je’
ahsade’go’	a hs ade’ go’
ayaknyatganye:’	a yakny at ganye :’
ëganenö:’	ë ga nenö :’
tšihsedehjih	tši hsedehjih
hehseshe’s	he hse she’ s
ayökninöe’t	a yökni nöe’ t
aedwashe:’	ae dwa she :’
dëdwawënye:’	d ë dwa wënye :’
o’shögwashe:’	o’ shögwa she :’
onönya’	o nöny a’
de’gyëdeih	de’ g yëdei h
ha’dedwaya’diha’	ha’ de dwa ya’di ha’
o’shenöe’t	o’ she nöe’ t
ha’dewënishäka:’	ha’ de w ënishä ka:’
hënötganyeh	hënö t ganye h
yea’danöwës	ye a’danöwë s
detonöhdëjös’öh	de tonö hdëjö s’ öh
de’shonöhdö’	de’ s honö hdö ’
aehnënöet	ae hnë nöet
daawi’	da a wi ’
o’seowi’	o’ se owi ’
ëyetinöhgwak	ë yeti nöhgwak
ehniyënëda’t	e hni yënëda’ t
ho’kë’	ho’ k ë ’
nëgayeök	n ë ga yeö k
snyahdëje’s	sny ahdëje’s
ëte:’	ë t e :’
sadiatödas	s adiatödas
oje’s	o je’s
honöja’dagëö’	honö ja’d a gëö’
gawënö’	ga wënö ’
heyëwödë’	he y ëwö dë’
sao’soägo’	sao’soägo’
ëöste’shö:’	ëö ste’shö :’
nö’önishe’t	n ö ’ö nishe’ t
kninöe’s	kni nöe’ s
wa’ögyö’se:’	wa’ ög yö’se :’
ahsatšonyanö:’	a hs atšony anö:’
o’dwadideni’	o’ d w adideni’
gëhögöshö’	g ëhögö shö’
deyoswëde’	de yo swëde’
ögwagwenye’s	ögwa gwenye’ s
ayöknishe:’	a yökni she :’
tgawenot	t ga weno t
o’keya’di’	o’ ke ya’di ’
akniköni’	a kni köni ’
todiyo’denyö’	t odi yo’de nyö ’
aösashe:’	a ösa she :’
waöwögë’	wa öwö gë ’
odö’öh	odö’öh
neogë’	neogë’
hoya’dayë’hisgöh	ho ya’d a yë’ his göh
wadiyashë’	wadi yashë ’
ëyögegë’	ë yöge gë ’
dëswadawënye:’	d ë sw ada wënye :’
jodiha:’kdöh	j odi ha:’kd öh
hedës	he dë s
daënöwënye:’	da ënö wënye :’
dawënötak	d a wënö tak
o’sesgatgwëh	o’ se sgatgwë h
ëyagwat	ë yagwa t
nisgowakneh	ni s gowak neh
dëswë’nyaë’	d ë sw ë’nya ë’
tših	tših
niyoisda’eh	ni yo isda ’eh
dodënönyö’	d o dënö nyö ’
waënidë:’	wa ëni dë :’
dasgawagë’t	d a s ga wagë’t
aösëdë:’	a ösë dë :’
ahša’k	a hš a’ k
wajesa’geh	w ajesa’geh
sdake’	s dake ’
ya’nih	y a’nih
nidwadih	ni dw adih
nëyönishe’t	n ë yö nishe’ t
daesnyadawënye:’	d ae sny ada wënye :’
aknigöë’	ak nigöë ’
sögwe’öweh	s ögwe ’öwe h
kenöe’öh	ke nöe’ öh
niyöh	ni yö h
wa’agyadiwago’	wa’ agy ad iwa go’
ënöjo:’dat	ënö jo:’dat
o’shagoya’dageha’	o’ shago ya’d a geh a’
o’sknigë’	o’ skni gë ’
gadawëh	g adawë h
hösadiyö’	h ösa di yö ’
yeadöhgwa’geh	ye adöh gwa’ geh
gagawihsa’	ga gawihs a’
awa’hödë’	a wa ’hö dë’
gaji’gayasdë:’	ga ji’gaya sdë :’
adešohgwa’shä’	adešohgwa’ shä’
ayatgëh	a y atgë h
ëdah	ëdah
gaya’dënyo’	ga ya’d ënyo’
höwöshe’s	höwö she’ s
nëhše:’	n ë hše :’
aedwaya’k	ae dwa ya’ k
hohodö’	hohodö’
aeswatga’	ae sw atga’
ëdwadeyës	ë dw ade yës
dashëönyö:’	d ashëönyö :’
nijagyöshön	ni j agy öshö n
ho’tšadawënye:’	ho’ tš adawënye :’
o’tgek	o’ t g e k
niyawëdetgäde’	ni y awëdetgäde ’
ëhsadënö’geät	ë hs adënö’geät
hadejë’s	h adejë’s
ögwanöe’öh	ögwa nöe’ öh
asgya’dageha’	a s g ya’d a geh a’
ögwatganyeh	ögw at ganye h
dëswatgweök	d ësw at gweö k
gonöe’s	go nöe’ s
ëyonödi’	ë yo nödi ’
niadiyehak	ni adi ye ha k
ögwawëh	ögwa wë h
snöge’	s nöge ’
dewagya’dowedöh	de wag ya’d owe döh
hëyea’	h ë y e a ’
de’shonöh	de’ s ho nöh
hadiwisdo’yas	hadi wisd o ’yas
shögwawih	shögwa wi h
tšionödeo’	tši onö deo ’
hëöweshö’	hëöwe shö’
ohiyo’	o h iyo ’
gokwanösde’	go kwa nösde ’
odikönih	odi köni h
ësnyajënöni’	ë sny ajënöni ’
ayagoyëda’k	a yago yë da ’k
aënöde’go’	a ënö de’ go’
ëyadënodë’	ë y adëno dë’
tsa’gajo’dat	tsa’ g ajo’dat
dösayadä’t	dösa y adä’t
ösadës	ösa dë s
sheswaya’dagehëh	sheswa ya’d a geh ëh
o’hasdëh	o ’hasdë h
odojëh	o dojë h
niyohsinök’ah	ni yo hsinök’ ah
hadihsënöwanës	hadi hsënö wanë s
nënöhdönyöh	nën öhdö nyö h
dawadi’sdagën	da w adi’sda gën
ëwënötganye:’	ë wënö t ganye :’
hösaowih	hösa owi h
asheswagë’	a sheswa gë ’
waagë’	wa a gë ’
dejodiha:’kdöh	de j o diha:’k dö h
edwahsawë’	e dw ahsa wë’
nö’gyë’	n ö ’g yë ’
yökidës	yök idë s
gyadatawak	gy adatawak
waga’ëyö:’	w a ga’ëyö :’
agya’dageha’	a g ya’d a geh a’
ëswajo:’dat	ë sw ajo:’da t
dësnideni’	d ë sni deni ’
dëdwanöwöyën	d ëdwa nöwöyën
ganesdä’gegwah	ga nesdä’ ge gwah
akno’ëgeh	ak no’ë geh
nö’oiwage’he’t	nö’ o iwa ge ’he’ t
yödejë’s	yö dejë’ s
jögwahdëjöh	j ögwa hdëjö h
odihšönih	odi hšöni h
agatgwenih	ag at gweni h
wa’o’hasdëh	wa’ o ’hasdë h
ögwajo’dadöh	ögw ajo’da döh
waodiyë’gwahsöwi’	wa odi yë’gwa hsöwi ’
gwagëh	gwa gë h
onë’da’	o në’d a’
waöwöyonyanö:’	wa öwö yony anö :’
hahseta’	ha hse ta’
dwataine’	dwa tai ne’
ëönöhdök	ë önö hdö k
ënötgweni’	ënö t gweni ’
oga’sdä:’	o ga’sdä :’
wa’ökniowi’	wa’ ökni owi ’
otgwëhsa’geh	o tgwëhsa’ geh
shedwanöe’s	shedwa nöe’ s
ögwëdës	ögwë dë s
ëshedwagë’	ë shedwa gë ’
edwadeyës	e dw ade yës
watgëh	w atgë h
edwatšonyanö:’	edw atšony anö :’
ajowi’	a jowi ’
sadiwatödat	s ad iwa töda t
deyögwatahgwëh	de yögw atahgwë h
nögwe’dase:’	n ögwe ’da se:’
o’wënöhsawë’	o’ wënö hsa wë’
ëdwadzagö’	ë dwa dzagö ’
ëdwatgëh	ë dw atgë h
hëödia’	h ëödi a ’
hëkne:’	h ë kn e :’
sawiyohe’t	sa w iyo he’ t
ënië’	ë ni ë ’
ahseyë’he’t	a hse yë’ he’ t
o’gego’	o’ ge go ’
ögwayënëda’öh	ögwa yënëda’ öh
edwadowi’	e dw adowi ’
dagyawënye:’	d a g yawënye :’
tšitoiwihsakdöh	tši to iwi hsak döh
agajowi’	ag ajowi ’
wadiya’dade’	wadi ya’d ade ’
aganöge’	a ga nöge ’
yöde’gwas	yö de’gwas
wa’ën	wa’ ë n
ëjadak	ë j adak
da’ogwenyöh	da’ ogwe nyö h
tganödayë’gwah	t ga nödayë’ gwah
deyöknyawënyeh	de yökny awënye h
yenönyöh	ye nönyö h
agiwaögëh	ag iwa ög ëh
ëhsesnye’t	ë hs esnye’ t
wa’öjä’dak	wa’ ö jä’dak
wa’esagë’	wa’ esa gë ’
agaje’s	ag aje’ s
hwaëne:’	h w aën e :’
agashä:’s	ag ashä:’s
shehniya’dagehas	shehni ya’d a geh as
höwöwih	höwö wi h
aknigo’	a kni go’
nöwögajeö’	n öwö gajeö’
dwa’höta’	dwa ’hö ta’
ëtgënöhdö’	ë t g ënöhdö ’
hae’sek	h a e’s ek
o’jagwadë’	o’ j agw adë ’
de’tonöhdö’	de’ to nöhdö ’
agatahgwëh	ag atahgwë h
gawajiyäde’	ga wajiyä de’
so’ah	so’ah
oshaisda’shö’öh	o shaisda’ shö’öh
wa’agwënö’geät	wa’ agw ënö’geä t
gëö’	g ëö ’
wa’akidë:’	wa’ ak idë :’
swegëonö’	swegë onö’
gaëwë:’	ga ëwë :’
dawënödawënye:’	da wënö da wënye :’
ëyakniyeä’dak	ë yakni yeä’dak
wënishäde’	w ëni shä de ’
hënödawëh	hënö dawë h
saöhdagöh	sa öhd a göh
swayë’he’s	swa yë’ he’ s
deonödögodöje’	de onö dögo dö je’
dënötak	d ën ötak
wa’o’dëöje’	wa’ o ’dëö je’
o’gyagë’t	o’ g yagë ’t
ëhsesënösho’	ë hs esënösho’
hënögwe’da’shö’	hënö gwe ’da’ shö’
dëinöönyö:’	dë i nöö nyö :’
gaswëhta’	ga swëh ta’
waöwö’geosäh	waöwö ’geosäh
ayonöja’dageh	a yonö ja’d a geh
daedwawënye:’	d ae dw awënye :’
ayötšonyanö:’	a yö tšony anö :’
dayöwënye:’	d a yö wënye :’
ëdwënöet	ë dw ënöe t
tadiyëdih	t adi yëdi h
wa’ögyö’s	wa ’ ög yö ’s
yeadö’s	ye adö ’s
ikne:’	i kn e :’
ëyögwa’nigöiyok	ë yögwa ’nigö iyo k
ëyaknyajeä’t	ë yakny aje ä’ t
o’gyatganye:’	o’ gy at ganye :’
nëöganya’k	n ëö ganya’ k
ayeshe:’	a ye she :’
ëgadeköni’	ë g ade köni ’
ha’dewënishägeh	ha’ de w ëni shä geh
sagat	sa ga t
o’sheshe:’	o’ she she :’
nöwödiye:’	n öwödi ye :’
o’kyadönyö:’	o’ k yadö nyö :’
ëjiswahdëdi’	ë ji sw ahdëdi’
jo’äga’	j o’äg a’
aesnyadaöhdiyos	ae sny ada öhd iyo s
wa’höta’	w a’hö ta’
hehša’dagehëh	he hš a’d a geh ëh
ëyödöishë:’	ë yö döi shë :’
ögwe’öweshö’öh	ö gwe ’öwe shö’öh
todiyö’dahgöh	t odi yö’d ahgöh
hëyenegeä’	h ë ye neg e ä’
wadiatödat	w adi atöda t
hesakdönö’	he s akdö nö’
agajëgwah	ag ajëgwa h
nö’deswa’nëyanode’	nö’ de swa ’nëyanod e’?
wa’ödënyet	wa’ ö dënye t
shedwanöe’öh	shedwa nöe’ öh
eogadoishë:’	eog ad oi shë :’
tedë’	tedë’
ögwatödaje’	ögw atöda je’
dö’ögwayëda’k	dö’ ögwa yë da’ k
aögeowi’	a öge owi ’
edwë’	e dw ë’
ganëhdëta’	ga nëhdë ta’
ga’hahda’	ga ’hahd a’
jih	jih
niayehak	ni a ye hak
ayësegë:’	a yëse gë :’
tšaksa’ah	tš a ksa’ ah
tadinögenyö’	t adi nöge nyö ’
dayeya’dowet	da ye ya’d owe t
gahogaëndo’	ga hogaën do’
hojöh	hojöh
dëyagodawënyeak	d ë yago da wënye ak
onökda’	o nökd a’
o’dwawënye:’	o’d wa wënye :’
dwë’jö’	dw ë’jö ’
sgya’dagehëh	s g ya’d a geh ëh
gya’dä:’s	g ya’d ä:’ s
ëshehnigë’	ë shehni gë ’
niganyo’da’s’ah	ni ganyo’ da’s’ ah
niwagyahdowe’shäyë’	ni wag yahdowe’shä yë’
o’sadeyës	o’ s adeyës
goja’dagehëh	go ja’d a geh ëh
wa’öta’dö:’	wa’ ö ta’dö :’
ësayë’gwahsöwi’	ë sa yë’gwa hsöwi’?
wënödöh	w ënödö h
haša’däje’	h a ša’d äje’
o’sadiatödat	o’ s adiatöda t
ganö’dzayë’	ga nö’dzayë’
akniowi’	a kni owi ’
nyögwa’	nyögwa’
swajöh	sw ajö h
oiwawehda’shö’	o iwa wehda’ shö’
wagegë’	w age gë ’
o’shegë’	o’ she gë ’
o’shaknishe:’	o’ shakni she :’
ëyajëno’kdë’	ë y ajëno’k dë’
o’sego’	o’ se go’
shonödaje’	s honö daje’
niga’sehdase’	ni ga’sehd a se’?
jödöh	jödöh
wajeä’ta’	w ajeä’ ta’
ayeögo’	a ye ö go’
ahtšo’gwëh	ahtšo’gwëh?
eshedwagë’	e shedwa gë’
dëhnideni’	d ë hni deni’
deodiya’dowedöje’	de odi ya’d owe dö je’
haöhdagöh	ha öhd a göh
shagojowehgowah	shago joweh gowah
o’sheswaowi’	o’ sheswa owi ’
o’gwësa’	o’ gw ësa’
niodi’seo’dëh	n iodi ’se o’dë h
weso’	w eso ’
o’gaiwayeih	o’ ga iwa yei h
dëgëh	d ë gë h
aoya’dageha’	a o ya’d a geh a’
hodi’nosha’s	hodi’nosha’s
akisot	aki sot
ëse’sek	ë s e’s ek
shakninöe’s	shakni nöe’ s
eshehniowi’	e shehni owi ’
honötgwëönyö’	honö t gwëö nyö ’
niyögwawis	ni yö gwawis
ësa’nigöëyëda’t	ë sa ’nigöë yë da’ t
ëkni’	ë kn i ’
ëdwadiatödat	ë dw adiatöda t
wa’aknyahdëdi’	wa’ akny ahdëdi’
thëne’s	t hën e’s
ënödaödö:’	ënö da ödö :’
ahsades’a:’	a hs ades’a :’
ëgajo:’data’	ë g ajo:’d a ta’
gogwenye’s	go gwenye’s
sa’niënöhö’s’ah	sa’ ni ënö hö’ s’ah
toë’sgëöh	t o ë’sg ëöh
aesatödeh	ae s atöde h
aesnyade’go’	ae sny ade’go’
esnië’	e sni ë ’
agwa’sehdayanowe’	agwa’ sehd a yanowe’
aënöjënöni’	a ënö jënöni ’
ëgöhek	ë g öhe k
dësek	d ë se k
hösaënötšisdöni’	h ösa ënö tšisd öni ’
de’o’dënö’	de ’o’dë nö’
ögwaowih	ögwa owi h
ëhsënö’geät	ë hs ënö’geä t
awadiyë’he’t	a wadi yë’ he’ t
heyo’dëh	he y o’dë h
wadö:’	w adö :’
awëdetgädek	awëdetgäde k
waösanöe’t	wa ösa nöe’ t
yödekwahgwa’	yö dekwahgwa’
kyadenyöh	k yade nyö h
ho’gëhödaje’	ho’ g ëhöd a je’
wadikwiyoh	wadi kw iyo h
gadö’s	g adö ’s
hëkea’	h ë ke a’
o’tgyahsëto’	o’t gy ahsë to’
wadiwahdëdi’	wad iwa hdëdi’
ige’s	i g e’s
döges	döges
o’gaköni’	o’ ga köni ’
heyakne:’	he yakn e :’
ahsënö’geät	a hs ënö’geä t
awe’öjeh	awe’öjeh
eshehnidë:’	e shehn idë :’
gohdahgwayë’	go hdahgwa yë’
deswa’nya:’	de swa ’nya :’
ase:’	a s e :’
yötgëös	yö t gëö s
honënöhdönyöh	hon ënöhdö nyö h
gayëtwëh	ga yë twëh
ho’wëöto’	ho’ w ëöto’
aye:’	aye:’
heša’dagweniyos	he ša’d a gwen iyo s
wadëninöhšowanëh	w adëninöhšo wanë h
wadiyëönö’	w adi yëönö’
ha’deyagwaya’dih	ha’ de yagw aya’di h
hënöhsaha’	hënö hsa ha’
ëyötga’	ë yö tga’
ëyeä’dak	ë ye ä’dak
hadijinöshö’	hadi jinö shö’
ëdwades’a:’	ë dw ades’a :’
o’wajä’dak	o’ w ajä’da k
ayonötgato’	a yonö t ga to’
ayaknyadënodë’	a yakny ad ëno dë’
dödasahget	döda sa hget
gwawae’	gwa wae’
jadak	j ada k
saënötgato’	sa ënö t ga to’
sawadëhgodë’	sa w adëhgodë’
gaiwa’	ga iwa ’
dadeni’	d adeni ’
waonöe’t	wa o nöe’ t
asek	a se k
o’oänöhö’	o’oänöhö’
ëyenegeä’	ë ye neg e ä’
nëgayeit	n ë ga yeit
ëskanö’gëök	ë ska nö’gëö k
honödiwade’	honö d iwa de’
gadöshä’	ga döshä’
dawadëdi’	d aw adëdi’
waögeshe:’	wa öge she :’
adeshä’shö’öh	adeshä’ shö’öh
o'watšonyanö:’	o' w atšony anö :’
shawënöyë:’	s ha wën ö yë :’
hënödöh	hënö dö h
ëödiatödat	ë öd iatöda t
osdë’sä’	osdë’sä’
gatgënis’a’has	g at gënis’a’ha s
dödaya’gwe:’	dö d a ya’gwe:’
dëjagwadëdi’	dë j agw adëdi’
o’wahdzadë’	o’ w ahdzadë’
gahsa’ö:’	ga hsa’ö :’
waoiwanägo’	wa o iwan ägo ’
dawatgë’ö:’	da wa tgë’ö :’
ëgani’	ë gani ’
agejiyäetgë’	age jiy äetgë
ëwöetgë’t	ë wöetgë’ t
oyëhsä:’	o yëhsä:’
aögyanotgëni’	a ög yanotgëni ’
aga’hön	aga ’hön
agahgaië’öh	aga hgai ë’ öh
ageshani’öh	age shani’ öh
agwe’s	agw e’s
agwagwegöh	agwa gwegö h
dedzaöh	de dza ö h
dejohatenöh	de jo hatenö h
de’oha’danö’	de’ o ha’danö ’
de’ogayës	de’ o gayë s
dodiwagehëh	d odi wagehë h
dëtodiyöje’	dët odi yö je’
dëödiwašnye:’	dë öd iwa šnye :’
dödayagwayö’	döda yagwa yö ’
ga’sgwihsa’	ga ’sgwihsa ’
gejio’gwa’geh	ge jio’gwa’ geh
gonyane’	go nyan e’
godawëh	go dawë h
godä’nëdakdöh	go dä’nëdakdö h
gëöje’	gë öje ’
hiya’dih	hi ya’ di h
hishönegwah	hi shöne gwah
hadënöh	ha dënö h
ha’dösawagya’dis	ha’ dösa wag ya’di s
hehsö’neh	he hsö’ neh
hejojö’döh	he jojö’dö h
hëhdzö’	hëh dzö ’
hëne’s	hën e’s
hëöyö’	hë ö yö ’
nëyodo’kda’k	në yo do’k da’k
nö’gë:’	nö’ gë :’
oda’geo’kdaje’	o da’geo’kd aje’
okasha’	o ka sha ’
ojinöya’da’	o jinöya’d a’
onödöišöhgöh	onö döišöhg öh
onökda’geh	onö kda’ geh
osae’dajisgwa’	o sae’da jisgw a’
oya’shö’öh	o ya’ shö’öh
o’yagaën	o’yagaë n
o’gade’nyöh	o’ ga de’nyö h
o’shagaödö:’	o’ shag aödö :’
shagoiödas’öh	shago iödas’ öh
taëne’sek	ta ëne’s ek
tohah	to hah
tsa’gadaödö:’	tsa’ ga daödö :’
wa’agonö’kwëh	wa’ ago nö’kwë h
wa’ödaödö:’	wa’ ö daödö :’
wa’ögaödönyö:’	wa’ ö gaödönyö :’
yödeës	yö de ës
ësaswe’nönök	ë saswe’nönök
ësgwanö’kwa’seak	ë sgwa nö’kwa’se ak
